+---+---+---+---+---+---+---+---+---+---+---+---+---+---+---+---+
|       |       |       |       |   |   |           |           |
+   +   +   +   +   +   +   +   +   +   +   +   +---+   +---+   +
|   |   |   |       |       |               |       |       |   |
+   +   +   +   +   +   +   +   +   +   +---+   +   +---+   +   +
|   |   |   |   |       |       |   |   |       |       |   |   |
+   +   +   +---+---+---+---+---+---+   +   +   +   +   +   +   +
|   |   |   |   |       |   |       |       |       |   |   |   |
+   +   +   +   +   +   +   +   +   +---+---+---+   +   +   +   +
|   |   |   |       |       |   |   |           |       |   |   |
+   +   +   +   +---+---+   +   +   +   +---+   +---+   +   +   +
|   |   |   |           |       |       |               |   |   |
+   +   +   +   +---+   +---+---+---+---+   +---+---+---+   +   +
|   |   |   |   |           |           |           |       |   |
+   +   +   +---+   +---+   +   +---+   +---+---+   +   +---+   +
|   |   |   |   |           |       |               |       |   |
+   +   +   +   +---+   +---+       +   +---+---+---+---+   +   +
|   |   |       |           |       |   |       |       |   |   |
+   +   +   +   +   +---+---+   +---+   +   +   +   +   +   +   +
|   |   |   |   |       |   |               |       |       |   |
+   +   +   +   +---+   +   +---+---+---+---+---+---+---+---+   +
|   |       |       |           |       |       |       |       |
+   +   +---+   +   +---+   +---+   +   +   +   +   +   +   +---+
|   |   |       |               |   |       |       |   |       |
+   +   +   +---+---+---+---+---+   +   +---+---+   +   +---+   +
|   |       |       |       |   |           |           |   |   |
+   +---+---+   +   +   +   +   +   +---+---+---+---+   +   +   +
|   |   |   |   |   |   |   |           |       |           |   |
+   +   +   +   +   +   +   +   +   +   +   +   +   +---+   +   +
|                               |   |       |       |       |   |
+   +   +   +   +   +   +   +   +   +   +   +   +   +   +   +   +
|   |   |   |   |   |   |   |           |       |       |       |
+---+---+---+---+---+---+---+---+---+---+---+---+---+---+---+---+
