+---+---+---+---+---+---+---+---+---+---+---+---+---+---+---+---+
|                                                               |
+   +---+---+---+---+---+---+---+---+---+---+---+   +---+   +---+
|       |                                   |                   |
+   +   +   +---+---+---+---+---+---+---+   +---+---+---+   +   +
|   |   |                                               |   |   |
+   +   +   +---+---+---+---+---+---+---+---+---+---+   +   +   +
|   |   |       |   |                               |   |   |   |
+   +   +   +   +   +   +---+---+---+---+---+   +   +   +   +   +
|   |   |   |   |   |   |                   |   |   |   |       |
+   +   +   +   +   +   +   +   +---+---+   +   +   +   +   +   +
|       |           |   |   |                       |       |   |
+   +---+   +   +   +   +   +   +---+---+   +---+---+   +---+   +
|   |   |   |   |   |   |   |               |           |   |   |
+   +   +   +   +   +   +   +---+---+   +   +   +---+---+   +   +
|   |   |   |   |   |   |   |       |   |   |       |   |   |   |
+   +   +   +   +   +   +   +   +   +   +   +   +   +   +   +   +
|   |   |               |   |       |       |   |       |   |   |
+   +   +   +---+---+---+   +---+   +---+---+   +   +   +   +---+
|   |   |   |           |                   |   |   |       |   |
+   +   +---+   +---+   +   +---+---+---+   +   +   +---+   +   +
|   |   |   |   |       |                   |           |       |
+   +   +   +   +   +   +---+   +---+   +---+---+---+   +   +   +
|   |       |       |   |               |                   |   |
+   +   +   +   +---+   +---+---+   +---+   +---+---+---+---+   +
|       |       |       |           |                       |   |
+---+---+---+---+   +---+---+   +---+---+---+---+---+   +---+   +
|                       |                       |               |
+   +---+---+   +---+   +---+---+   +---+---+   +---+---+   +   +
|   |                           |                           |   |
+   +   +---+---+---+---+---+   +   +---+---+---+---+---+---+   +
|   |                           |                               |
+---+---+---+---+---+---+---+---+---+---+---+---+---+---+---+---+
