+---+---+---+---+---+---+---+---+---+---+---+---+---+---+---+---+
|                                                               |
+   +---+---+---+---+---+---+---+---+---+---+---+---+---+---+   +
|   |       |       |                                           |
+   +   +   +   +   +   +---+---+---+---+---+---+   +---+   +   +
|       |       |       |   |       |       |       |       |   |
+   +   +---+---+---+   +   +   +   +   +   +   +---+   +---+   +
|   |               |   |       |       |       |       |   |   |
+   +---+---+---+   +   +   +   +   +   +   +---+   +---+   +   +
|           |       |   |   |       |       |       |       |   |
+---+---+   +   +---+   +   +---+---+---+---+   +---+   +   +   +
|       |   |       |   |       |           |           |   |   |
+   +   +   +---+   +   +   +   +   +---+   +---+---+---+   +   +
|   |   |       |   |   |   |       |               |   |   |   |
+   +   +   +---+   +   +---+---+---+   +---+---+   +   +   +   +
|   |       |       |   |   |       |               |   |   |   |
+   +   +---+   +---+   +   +   +   +   +---+   +   +   +   +   +
|   |   |       |   |   |           |   |       |   |   |   |   |
+   +---+   +---+   +   +   +---+---+---+   +---+   +   +   +   +
|           |       |   |                       |   |   |   |   |
+---+   +---+   +   +   +   +---+---+---+---+   +   +   +   +   +
|           |   |   |   |                           |       |   |
+---+   +---+   +   +   +---+---+---+---+---+---+   +---+   +   +
|           |   |   |                           |   |       |   |
+---+   +---+   +   +   +---+---+---+---+   +   +---+   +---+   +
|           |   |   |   |           |       |       |       |   |
+---+   +---+   +   +---+   +---+   +   +   +   +   +---+   +   +
|               |               |       |       |       |   |   |
+   +---+---+---+---+   +---+   +---+---+---+   +---+   +   +   +
|       |       |       |                               |   |   |
+   +   +   +   +   +   +---+---+---+---+---+   +---+   +   +   +
|   |       |       |                                   |       |
.---+---+---+---+---+---+---+---+---+---+---+---+---+---+---+---+
