+---+---+---+---+---+---+---+---+---+---+---+---+---+---+---+---+
|                                                               |
+   +---+---+   +---+---+---+---+---+---+---+   +---+---+---+   +
|   |           |               |               |           |   |
+   +---+---+---+   +   +   +---+---+   +   +---+   +   +---+   +
|       |   |       |   |           |   |           |       |   |
+   +   +   +---+   +   +   +   +   +   +---+---+---+---+   +   +
|   |       |       |   |   |   |   |   |   |   |           |   |
+   +   +   +   +   +   +   +---+   +   +   +   +   +---+---+   +
|   |   |       |   |   |       |       |   |       |       |   |
+   +---+   +   +   +---+---+   +---+   +   +   +---+   +   +   +
|       |   |   |           |       |       |   |       |   |   |
+   +---+   +---+---+   +---+---+   +---+---+   +   +---+   +   +
|   |           |   |           |           |       |       |   |
+   +   +---+---+   +---+   +---+---+   +   +---+---+   +---+   +
|   |               |   |   |       |   |                   |   |
+   +   +   +---+   +   +   +   +   +---+---+---+---+---+   +   +
|   |   |       |   |       |                   |           |   |
+   +   +---+   +   +---+---+---+---+---+---+   +   +---+---+   +
|   |   |   |   |   |           |   |       |       |           |
+   +   +   +   +   +---+   +---+   +---+   +---+   +   +---+   +
|   |       |               |       |               |       |   |
+   +---+   +   +---+---+   +---+   +   +---+---+---+---+   +   +
|                       |       |       |                   |   |
+   +---+---+   +---+---+   +---+   +---+   +---+   +---+   +   +
|   |           |               |   |       |       |   |   |   |
+   +   +---+   +   +---+---+---+   +   +---+   +---+   +   +   +
|   |   |       |   |       |       |   |               |   |   |
+   +   +   +---+   +---+   +   +---+---+   +---+---+---+   +   +
|   |   |   |       |           |                               |
+   +   +   +   +---+---+---+---+---+---+---+---+   +---+---+   +
|   |       |                                                   |
.---+---+---+---+---+---+---+---+---+---+---+---+---+---+---+---+
