+---+---+---+---+---+---+---+---+---+---+---+---+---+---+---+---+
|                                                               |
+   +---+---+---+---+---+---+---+---+---+---+---+---+---+---+   +
|                           |                                   |
+---+   +---+---+---+---+   +   +---+---+---+---+---+---+---+---+
|           |               |               |                   |
+---+   +---+   +---+---+---+---+---+---+   +   +   +---+---+   +
|           |   |               |           |   |           |   |
+---+   +---+   +   +---+   +---+   +---+---+   +---+   +---+   +
|           |   |       |       |       |       |       |       |
+---+   +---+   +---+   +---+   +---+   +   +---+   +   +   +---+
|           |       |       |   |           |       |   |       |
+---+   +---+---+   +---+   +   +   +---+---+   +   +   +---+   +
|           |           |   |       |   |       |       |       |
+---+   +---+---+---+   +   +---+---+   +   +   +   +---+   +---+
|       |           |   |   |       |       |   |   |           |
+   +   +   +---+   +   +   +   +   +   +---+   +   +   +---+   +
|   |   |       |   |       |                       |           |
+   +   +---+   +   +---+---+---+---+---+---+---+---+---+   +---+
|               |   |           |           |       |           |
+   +   +---+---+   +   +---+   +   +---+   +   +   +---+---+   +
|   |       |       |   |       |   |   |   |   |           |   |
+   +   +   +   +   +   +   +---+   +   +   +   +---+---+   +   +
|       |       |   |   |       |       |   |       |       |   |
+   +   +   +---+   +   +---+   +---+---+   +---+   +   +---+   +
|   |                   |           |               |           |
+   +   +---+---+   +---+   +---+   +---+   +---+---+---+---+   +
|       |           |       |               |       |           |
+   +---+   +---+---+   +---+   +---+   +---+   +   +   +---+---+
|       |       |       |           |           |               |
+   +   +   +   +   +   +---+---+   +   +---+---+---+---+---+   +
|   |       |       |               |                           |
.---+---+---+---+---+---+---+---+---+---+---+---+---+---+---+---+
