+---+---+---+---+---+---+---+---+---+---+---+---+---+---+---+---+
|                           |       |                           |
+   +---+---+---+   +---+   +   +   +   +---+   +---+   +   +   +
|               |       |       |       |       |       |   |   |
+   +---+---+---+---+   +---+   +   +---+   +---+   +---+   +   +
|   |               |       |       |       |               |   |
+   +   +   +---+   +---+   +---+---+   +---+   +---+---+   +   +
|       |               |       |       |                   |   |
+---+---+---+---+---+   +---+   +   +---+   +   +---+   +---+   +
|                           |       |       |   |       |       |
+   +---+---+---+---+---+---+---+---+   +---+   +   +---+   +   +
|                           |                       |       |   |
+   +   +---+---+---+---+   +---+---+   +---+   +---+   +---+   +
|   |   |               |   |                   |       |       |
+   +   +   +---+---+   +   +---+---+   +   +---+   +---+   +---+
|   |   |   |       |   |   |           |   |       |           |
+   +   +   +---+   +   +   +   +   +   +   +   +---+   +---+   +
|       |           |   |   |       |   |   |       |           |
+---+   +---+---+---+   +   +---+---+---+---+---+   +---+   +---+
|                       |                   |   |       |       |
+---+   +---+---+---+---+---+---+---+---+   +   +---+   +---+   +
|                   |   |               |   |       |           |
+   +   +---+---+   +---+   +---+---+   +   +   +   +---+   +---+
|   |                   |   |       |   |   |   |       |       |
+   +   +---+---+   +   +   +   +   +   +   +   +   +   +---+   +
|   |           |   |   |   |   |   |   |   |   |   |       |   |
+   +   +---+   +   +   +   +   +---+   +   +   +   +---+   +   +
|       |   |   |   |   |   |           |   |   |       |       |
+   +   +---+   +   +   +   +---+---+---+   +   +   +   +   +   +
|   |   |                                   |       |       |   |
+   +   +---+---+   +   +   +---+---+---+   +   +   +---+   +   +
|   |               |   |                       |               |
.---+---+---+---+---+---+---+---+---+---+---+---+---+---+---+---+
