+---+---+---+---+---+---+---+---+---+---+---+---+---+---+---+---+
|       |                           |                       |   |
+---+   +---+---+   +---+---+   +   +---+   +---+---+---+   +   +
|   |       |       |       |   |       |       |       |   |   |
+   +---+   +   +---+   +   +   +---+---+   +---+   +   +   +   +
|   |           |       |   |       |   |   |   |       |       |
+   +---+---+   +   +---+   +   +---+   +   +   +   +   +   +---+
|       |           |       |               |   |       |       |
+   +---+---+   +---+---+---+   +---+---+---+   +---+---+   +---+
|                               |                               |
+   +---+---+   +---+   +---+---+---+---+   +---+---+---+---+---+
|   |           |               |   |       |   |   |       |   |
+   +   +---+---+---+---+   +   +   +   +---+   +   +---+   +   +
|   |               |   |   |   |       |                   |   |
+   +   +---+---+   +---+   +---+   +   +   +---+   +---+---+   +
|   |           |           |       |   |       |               |
+   +   +---+   +---+---+---+   +   +   +---+   +   +---+---+---+
|   |   |                   |       |   |           |           |
+---+   +---+---+   +---+   +   +---+---+   +   +---+   +---+   +
|                   |       |           |   |   |       |       |
+   +---+   +   +---+---+---+   +---+   +   +   +   +---+---+   +
|   |       |   |                   |       |       |   |       |
+   +   +---+   +   +---+---+---+   +   +---+   +---+   +---+   +
|       |       |       |       |   |   |       |       |       |
+   +---+   +   +---+   +   +   +---+---+   +---+   +---+---+   +
|           |   |       |   |           |                       |
+   +---+---+   +   +---+   +   +---+---+---+   +---+   +---+   +
|       |       |   |       |       |   |   |       |       |   |
+   +   +   +---+   +   +   +   +   +   +   +---+   +---+   +   +
|   |   |       |   |   |   |   |       |       |       |   |   |
+   +   +   +   +---+---+   +   +   +---+   +---+---+   +---+---+
|   |       |                                                   |
.---+---+---+---+---+---+---+---+---+---+---+---+---+---+---+---+
