+---+---+---+---+---+---+---+---+---+---+---+---+---+---+---+---+
|   |                                                       |   |
+   +---+---+---+---+---+   +---+---+---+   +---+---+   +   +   +
|                           |           |   |   |   |   |   |   |
+   +---+   +   +---+   +   +---+   +   +---+   +   +---+   +   +
|       |   |   |       |   |   |   |           |               |
+   +---+---+   +---+   +   +   +---+---+   +   +   +---+---+   +
|       |   |       |   |   |       |   |   |       |   |   |   |
+   +---+   +   +---+   +   +---+   +   +   +---+---+   +   +   +
|           |   |       |   |   |       |               |       |
+   +---+   +   +---+   +---+   +   +---+---+---+---+   +   +---+
|   |   |   |   |       |           |   |       |   |           |
+   +   +   +   +   +---+   +---+   +   +---+   +   +---+---+   +
|   |   |       |   |           |       |               |       |
+   +   +   +   +---+   +---+---+---+   +   +---+   +   +   +   +
|   |   |   |   |       |   |       |   |   |       |       |   |
+   +   +   +---+---+   +---+   +   +   +   +   +---+   +---+   +
|   |       |       |       |       |   |   |   |       |       |
+   +---+---+   +   +---+---+   +---+   +   +   +---+   +---+   +
|               |   |       |   |           |       |       |   |
+   +---+---+   +   +   +   +   +---+   +   +---+   +---+   +   +
|   |           |   |   |   |           |       |       |       |
+   +   +---+---+---+   +   +---+---+---+---+   +---+   +---+   +
|   |                   |   |                       |           |
+   +---+---+---+   +   +   +   +---+---+---+   +   +---+---+   +
|   |               |       |   |               |   |       |   |
+   +   +---+---+---+---+---+---+---+---+   +---+   +   +   +   +
|   |               |   |                           |   |   |   |
+   +---+---+---+   +   +   +---+---+---+---+---+---+---+   +   +
|   |               |   |                                   |   |
+   +   +---+---+---+   +---+---+---+---+---+---+---+---+   +   +
|   |                                                           |
.---+---+---+---+---+---+---+---+---+---+---+---+---+---+---+---+
