+---+---+---+---+---+---+---+---+---+---+---+---+---+---+---+---+
|   |           |                                           |   |
+---+---+   +---+---+---+   +---+---+---+   +   +---+   +---+   +
|       |   |               |               |   |   |   |   |   |
+---+   +   +   +---+---+   +   +---+---+---+   +   +   +   +   +
|   |           |               |               |   |       |   |
+   +   +---+   +---+---+---+   +   +---+---+   +   +   +   +   +
|   |   |                           |                   |       |
+   +   +   +---+---+   +---+---+---+---+---+   +---+   +   +   +
|   |   |       |   |   |                       |       |   |   |
+   +   +   +   +   +   +---+---+---+   +---+---+   +---+   +   +
|       |   |           |           |                   |   |   |
+   +   +   +---+---+   +   +---+   +---+---+---+   +   +---+   +
|   |       |   |       |   |                   |   |   |   |   |
+   +---+---+   +   +   +---+---+---+   +---+---+   +   +   +---+
|       |           |   |   |       |   |           |       |   |
+---+---+   +   +---+---+   +   +   +   +---+---+   +   +   +   +
|           |               |                   |       |       |
+   +---+---+---+---+   +---+---+---+   +---+   +---+   +   +   +
|   |           |       |       |                       |   |   |
+   +   +   +   +---+---+   +   +---+---+---+   +   +   +   +   +
|   |           |           |           |       |   |   |   |   |
+   +   +   +   +   +---+   +   +---+   +---+---+---+   +   +   +
|   |           |       |   |   |               |   |   |   |   |
+   +   +   +   +   +---+---+   +   +---+---+   +   +---+   +   +
|   |           |           |   |                   |   |   |   |
+   +---+   +   +---+---+   +   +---+---+---+---+   +   +   +   +
|       |       |           |       |           |           |   |
+   +   +---+---+   +---+---+   +---+---+---+   +   +---+   +   +
|   |       |       |       |   |                   |           |
+   +   +---+   +---+---+   +   +   +---+---+---+---+---+---+---+
|   |                                                           |
.---+---+---+---+---+---+---+---+---+---+---+---+---+---+---+---+
