+---+---+---+---+---+---+---+---+---+---+---+---+---+---+---+---+
|                                                               |
+   +---+---+---+---+---+---+---+---+---+---+---+---+---+---+   +
|   |       |       |                                           |
+   +   +   +   +   +   +---+---+---+---+---+---+   +---+   +   +
|       |       |       |                   |       |       |   |
+---+   +---+---+---+---+   +---+---+---+   +   +---+   +---+   +
|           |   |   |   |       |       |       |       |   |   |
+---+---+   +   +   +   +---+   +   +   +   +---+   +---+   +   +
|       |   |               |   |   |   |   |       |       |   |
+   +   +   +   +   +   +   +   +   +   +   +   +---+   +   +   +
|   |   |   |   |   |   |       |   |   |   |   |       |   |   |
+   +   +   +   +---+---+---+---+   +   +   +   +   +---+   +   +
|   |       |   |                   |       |       |       |   |
+   +---+---+   +   +---+---+---+---+---+---+---+---+   +---+   +
|           |   |   |       |       |   |   |   |       |       |
+---+   +   +   +   +   +   +   +   +   +   +   +   +---+   +   +
|       |   |   |       |   |                   |   |       |   |
+   +---+   +   +---+   +   +---+---+   +---+   +   +   +---+   +
|       |   |       |   |       |   |       |   |   |       |   |
+---+   +   +---+   +---+   +---+   +---+   +   +   +---+   +   +
|       |       |                       |   |   |   |       |   |
+   +---+---+   +   +   +---+---+   +   +   +   +   +   +---+   +
|       |   |   |   |           |   |   |   |       |       |   |
+---+   +   +   +---+---+---+   +---+   +   +   +---+---+   +   +
|       |       |   |   |   |       |   |   |               |   |
+   +---+   +---+   +   +   +---+   +   +   +---+---+---+---+   +
|   |       |                   |   |   |                   |   |
+   +   +   +   +   +   +   +   +   +   +---+---+---+---+   +   +
|       |       |   |   |   |       |   |                   |   |
+   +   +   +   +   +   +   +---+   +   +   +---+---+---+---+   +
|   |       |                           |                       |
.---+---+---+---+---+---+---+---+---+---+---+---+---+---+---+---+
