+---+---+---+---+---+---+---+---+---+---+---+---+---+---+---+---+
|   |       |           |                                       |
+   +---+   +   +---+   +   +---+---+---+---+---+---+---+   +   +
|   |       |   |       |               |           |       |   |
+   +   +---+   +   +---+   +---+---+   +   +---+   +   +---+   +
|   |       |   |                       |   |   |       |       |
+   +---+   +   +   +---+---+---+---+---+   +   +   +---+   +   +
|   |       |   |   |                   |   |               |   |
+   +   +---+   +   +   +---+---+---+   +   +---+---+---+---+   +
|   |           |   |   |               |       |               |
+   +---+---+---+   +   +   +---+---+   +---+   +   +---+---+   +
|               |   |   |   |                   |               |
+---+---+---+   +---+   +   +   +---+---+---+   +---+---+   +---+
|           |   |       |   |               |           |       |
+   +---+---+   +   +---+---+---+---+---+   +---+---+   +---+   +
|   |       |   |           |       |                   |       |
+   +   +   +   +---+   +---+   +   +---+---+---+---+---+   +   +
|   |   |   |   |                   |                       |   |
+   +   +   +   +   +---+---+---+---+   +---+---+---+   +---+   +
|   |   |   |   |   |       |       |                           |
+   +   +   +   +   +   +---+   +   +---+---+---+   +---+   +---+
|   |       |   |   |   |       |   |   |               |       |
+   +   +   +   +   +   +   +---+   +   +   +   +---+---+---+   +
|       |   |   |   |   |   |       |   |   |       |   |       |
+   +   +   +   +   +   +   +   +---+   +   +---+   +   +   +---+
|   |   |   |   |   |   |   |           |       |       |       |
+---+   +   +   +   +   +   +   +---+---+---+   +   +   +---+   +
|       |       |       |   |   |               |   |       |   |
+   +   +---+---+---+---+---+   +   +---+---+---+   +   +   +   +
|   |                           |                   |   |       |
+   +   +---+---+---+---+---+   +---+---+---+---+---+---+---+   +
|   |                                                           |
.---+---+---+---+---+---+---+---+---+---+---+---+---+---+---+---+
