+---+---+---+---+---+---+---+---+---+---+---+---+---+---+---+---+
|                                                               |
+   +---+---+---+---+---+   +---+---+---+   +---+---+---+---+   +
|       |                                   |                   |
+---+   +   +   +---+---+---+---+---+   +---+   +---+   +   +   +
|       |   |                                   |       |   |   |
+   +   +   +---+   +---+---+   +---+---+---+   +   +   +   +   +
|   |   |   |       |                           |   |   |       |
+   +   +   +   +   +   +---+---+---+---+---+   +   +   +   +   +
|       |       |       |                   |       |       |   |
+   +---+---+   +---+   +   +   +---+   +   +---+   +   +   +   +
|   |       |       |   |   |           |       |   |   |   |   |
+   +   +   +---+   +   +   +---+   +   +   +   +   +   +   +   +
|   |   |       |   |   |           |       |   |       |   |   |
+   +   +---+   +   +   +   +---+   +   +   +   +   +---+   +   +
|   |       |           |   |       |   |   |   |   |       |   |
+   +---+   +---+---+---+   +   +   +   +   +   +   +   +---+   +
|       |   |               |       |   |       |   |   |       |
+   +   +   +   +---+---+   +---+---+   +   +   +   +   +   +---+
|   |   |   |               |               |   |       |       |
+   +   +   +---+---+---+---+   +---+---+---+   +   +   +   +   +
|   |   |                   |                   |   |   |   |   |
+   +   +   +   +---+---+   +---+---+---+   +   +   +   +   +   +
|       |   |       |                       |   |   |   |   |   |
+   +---+   +   +   +   +---+---+   +---+---+   +   +   +   +   +
|   |       |   |                               |       |   |   |
+   +   +---+   +   +---+   +---+---+---+---+---+   +   +   +   +
|   |       |                           |           |   |       |
+   +---+   +   +---+---+---+---+---+   +   +---+---+---+   +---+
|       |       |                   |       |                   |
+   +   +---+---+   +---+---+---+   +---+---+   +---+---+---+   +
|   |                                                           |
.---+---+---+---+---+---+---+---+---+---+---+---+---+---+---+---+
