+---+---+---+---+---+---+---+---+---+---+---+---+---+---+---+---+
|   |                                           |       |       |
+   +   +   +---+---+---+   +---+---+---+---+   +   +   +   +   +
|   |   |   |       |       |                   |   |   |   |   |
+   +   +   +   +   +   +---+   +---+---+---+---+   +   +   +   +
|   |       |   |           |                   |   |       |   |
+   +---+---+   +---+---+---+---+---+---+---+   +   +---+---+   +
|               |   |                           |           |   |
+   +---+---+---+   +   +---+---+---+---+---+   +---+---+   +   +
|   |               |   |               |       |           |   |
+   +   +---+   +---+   +   +   +---+   +   +---+   +---+   +   +
|       |       |   |   |   |       |   |   |   |   |       |   |
+   +---+   +---+   +   +   +   +   +   +---+---+   +   +---+   +
|   |               |   |       |   |   |       |           |   |
+   +   +---+---+   +   +   +   +---+   +   +---+   +---+   +   +
|       |           |   |   |       |   |   |               |   |
+   +---+   +---+   +   +   +   +   +   +   +   +---+   +---+   +
|               |   |   |   |       |   |       |           |   |
+   +   +---+   +   +   +   +   +---+   +   +---+   +---+---+   +
|   |       |       |   |   |       |       |           |       |
+   +---+   +---+   +   +   +   +   +---+---+   +---+---+   +   +
|                   |       |   |   |           |           |   |
+---+---+---+---+   +   +   +   +   +   +---+   +---+   +   +   +
|                   |   |   |       |           |       |   |   |
+   +---+---+---+   +   +   +   +   +   +---+---+   +---+   +   +
|           |       |           |   |   |       |   |       |   |
+---+---+   +---+   +---+---+   +---+   +   +   +   +   +---+   +
|       |       |           |           |   |   |   |           |
+   +   +   +   +   +---+   +---+---+---+   +   +   +   +---+---+
|   |   |   |   |   |                       |       |           |
+   +   +   +   +   +---+---+---+---+---+---+---+---+---+---+   +
|   |       |                                                   |
.---+---+---+---+---+---+---+---+---+---+---+---+---+---+---+---+
