+---+---+---+---+---+---+---+---+---+---+---+---+---+---+---+---+
|                                                               |
+   +---+---+---+   +---+---+---+---+---+---+---+---+---+---+---+
|   |               |                                       |   |
+   +   +   +---+---+---+   +---+---+---+---+---+   +---+---+   +
|       |   |       |       |       |                       |   |
+   +---+   +   +---+   +---+   +   +---+   +   +---+   +---+   +
|       |   |   |       |       |           |       |           |
+   +---+   +   +   +---+   +   +   +   +---+---+   +   +---+   +
|   |   |   |       |       |   |   |                           |
+---+   +   +   +---+---+   +---+---+   +   +---+---+---+---+   +
|   |   |               |           |   |   |               |   |
+   +   +---+---+   +---+   +---+---+---+   +---+---+---+---+   +
|                       |               |                       |
+---+   +---+---+---+   +   +---+---+   +   +   +   +---+---+---+
|   |   |           |   |   |       |   |   |   |               |
+   +   +   +   +   +   +   +   +   +   +   +   +---+---+---+   +
|       |           |   |   |       |   |   |               |   |
+   +---+   +   +   +   +   +---+   +   +   +---+   +---+---+   +
|   |   |           |   |   |           |   |   |       |       |
+   +   +---+---+---+   +   +   +---+   +   +   +   +   +   +---+
|                       |   |   |       |   |       |   |       |
+   +   +   +   +   +---+   +---+---+---+   +   +---+   +---+   +
|   |   |   |   |   |           |   |       |       |   |       |
+   +   +   +   +---+---+---+---+   +   +---+   +---+   +   +---+
|   |   |   |                   |                               |
+   +   +   +---+---+---+---+   +---+---+---+---+---+---+   +   +
|       |       |   |                                   |   |   |
+   +   +   +---+   +   +---+---+---+   +---+---+   +   +   +   +
|   |                                   |           |   |       |
+   +   +---+---+---+---+---+---+---+---+---+---+---+   +---+   +
|   |                                                           |
.---+---+---+---+---+---+---+---+---+---+---+---+---+---+---+---+
