+---+---+---+---+---+---+---+---+---+---+---+---+---+---+---+---+
|                                                               |
+   +---+---+---+---+---+---+---+---+---+---+---+---+---+---+   +
|   |                                                           |
+   +   +---+---+---+---+---+---+---+---+   +---+---+---+---+   +
|   |   |                           |                       |   |
+   +   +   +---+---+---+   +---+---+---+---+   +---+---+   +   +
|   |   |   |   |       |           |   |       |           |   |
+   +   +   +   +   +   +---+---+   +   +   +---+   +---+---+   +
|   |   |   |       |   |       |       |   |               |   |
+   +   +   +   +---+   +   +   +---+   +   +---+---+---+   +   +
|   |   |   |       |   |   |       |       |               |   |
+   +   +   +---+   +   +   +---+   +---+---+   +---+---+---+   +
|   |   |           |   |   |               |           |   |   |
+   +   +---+---+---+   +   +---+---+---+   +---+---+   +   +   +
|   |   |       |       |   |           |               |   |   |
+   +   +   +   +---+   +   +   +   +   +---+---+---+---+   +   +
|   |   |   |       |   |   |       |           |           |   |
+   +   +   +---+   +   +   +---+---+---+   +---+   +   +   +   +
|   |   |   |       |       |           |       |   |   |   |   |
+   +   +   +   +---+   +---+---+   +   +---+   +   +---+   +   +
|   |   |   |           |       |   |       |               |   |
+   +   +   +---+---+---+   +   +   +---+   +---+   +---+   +   +
|   |   |               |   |   |       |       |       |   |   |
+   +   +---+---+---+   +   +   +---+   +---+   +---+   +   +   +
|   |   |               |   |   |           |       |       |   |
+   +   +   +---+---+---+   +   +---+---+   +---+   +---+   +   +
|       |   |               |   |               |       |   |   |
+   +   +   +---+---+---+   +   +---+---+---+   +---+   +   +   +
|   |   |                   |                   |           |   |
+   +   +---+---+---+---+---+---+---+---+---+---+---+---+---+   +
|   |                                                           |
.---+---+---+---+---+---+---+---+---+---+---+---+---+---+---+---+
