+---+---+---+---+---+---+---+---+---+---+---+---+---+---+---+---+
|       |                                                       |
+   +   +   +---+---+---+---+---+---+---+---+---+---+---+---+   +
|   |   |       |                                           |   |
+   +   +   +---+   +---+---+---+---+---+---+---+---+---+   +   +
|   |   |   |           |                               |       |
+   +   +   +---+   +---+   +---+---+---+---+---+---+   +---+---+
|   |   |   |           |   |                       |       |   |
+   +   +   +---+   +---+   +   +---+---+---+---+   +---+   +   +
|   |   |   |           |   |           |           |   |       |
+   +   +   +---+   +---+   +---+---+   +---+   +   +   +   +   +
|   |   |   |           |   |   |       |       |   |       |   |
+   +   +   +   +---+---+   +   +   +---+   +   +---+   +---+   +
|   |   |   |                       |       |   |               |
+   +   +   +---+---+---+   +---+---+   +   +---+   +---+   +---+
|   |   |   |       |       |           |   |                   |
+   +   +   +   +   +---+   +   +   +   +---+   +---+---+   +---+
|   |   |   |   |   |       |       |   |           |   |       |
+   +   +   +   +   +   +---+   +---+---+   +---+---+   +---+   +
|   |   |   |   |       |           |           |           |   |
+   +   +   +   +---+---+   +---+---+   +---+---+   +---+   +   +
|   |   |   |   |   |           |           |           |   |   |
+   +   +   +   +   +   +---+---+   +---+---+   +   +---+   +   +
|   |   |   |   |           |           |       |       |   |   |
+   +   +   +   +   +---+---+   +---+---+   +---+---+   +   +   +
|   |   |   |           |           |           |       |   |   |
+   +   +   +   +---+---+   +---+---+   +---+   +   +   +   +   +
|   |   |   |   |   |           |           |       |   |   |   |
+   +   +   +---+   +---+   +---+   +   +   +   +   +   +   +   +
|   |   |   |           |           |   |       |       |   |   |
+   +   +   +   +---+   +---+---+---+---+---+---+---+   +   +   +
|   |               |                                   |       |
.---+---+---+---+---+---+---+---+---+---+---+---+---+---+---+---+
