+---+---+---+---+---+---+---+---+---+---+---+---+---+---+---+---+
|                                                               |
+   +---+---+---+---+---+---+---+---+---+---+---+---+---+   +   +
|   |       |               |                               |   |
+   +   +   +   +---+---+   +---+   +---+---+---+---+---+---+   +
|   |   |   |       |           |           |               |   |
+   +   +   +---+   +---+---+   +   +---+   +---+   +---+   +   +
|   |   |   |   |           |   |   |           |       |   |   |
+   +   +   +   +---+---+   +   +---+---+   +---+---+   +   +   +
|   |   |               |   |           |           |   |   |   |
+   +   +---+---+---+   +   +---+   +---+---+---+   +   +   +   +
|   |       |   |       |       |           |   |   |   |   |   |
+   +---+   +   +   +---+   +   +---+   +---+   +   +   +   +   +
|   |   |       |       |   |       |           |   |   |   |   |
+   +   +---+   +---+   +   +---+   +   +   +---+   +   +   +   +
|   |       |       |       |       |   |       |       |   |   |
+   +   +   +---+   +---+   +   +   +   +   +   +---+---+   +   +
|   |   |   |           |   |       |   |   |           |   |   |
+   +   +   +---+---+   +---+---+---+   +   +   +   +   +   +   +
|   |   |   |       |           |       |       |   |   |   |   |
+   +   +   +   +   +---+   +---+---+---+---+---+---+   +   +   +
|   |   |   |   |       |       |           |   |       |   |   |
+   +   +   +   +---+   +---+   +   +   +---+   +---+   +   +   +
|   |   |   |   |       |           |   |           |       |   |
+   +   +   +   +   +---+---+---+---+   +---+   +   +---+   +   +
|   |   |   |   |                       |       |   |   |   |   |
+   +   +   +   +---+---+---+---+---+---+   +---+   +   +---+   +
|       |   |                                   |           |   |
+   +   +   +---+---+---+---+---+---+---+---+---+---+---+   +   +
|   |   |                                                   |   |
+   +   +---+---+---+---+---+---+---+---+---+---+---+---+---+   +
|   |                                                           |
.---+---+---+---+---+---+---+---+---+---+---+---+---+---+---+---+
