+---+---+---+---+---+---+---+---+---+---+---+---+---+---+---+---+
|                                                               |
+   +---+---+---+---+---+---+---+---+---+---+---+---+---+   +---+
|   |                                                           |
+   +   +---+---+---+---+---+---+---+---+---+---+---+---+   +   +
|   |   |                   |                               |   |
+   +   +   +   +---+---+   +---+   +---+---+---+---+---+---+   +
|   |   |   |           |       |                           |   |
+   +   +   +   +   +---+---+   +---+---+---+---+---+---+   +   +
|   |   |   |   |           |           |       |       |   |   |
+   +   +   +   +   +   +---+   +---+   +   +   +   +   +   +   +
|   |   |   |   |   |       |       |       |   |   |   |   |   |
+   +   +   +   +   +   +   +---+   +---+---+   +   +   +   +   +
|   |   |   |   |   |   |       |       |       |   |   |   |   |
+   +   +   +---+   +   +   +   +---+---+   +---+   +   +   +   +
|   |   |   |   |       |   |       |           |   |   |   |   |
+   +   +   +   +   +   +   +   +   +   +---+---+   +   +   +   +
|   |   |   |   |   |       |       |           |   |   |   |   |
+   +   +   +   +   +---+   +---+---+---+---+   +   +   +   +   +
|   |   |   |   |           |               |   |   |   |   |   |
+   +   +   +   +---+---+---+---+---+   +---+   +   +   +   +   +
|   |   |   |   |                   |       |   |   |   |   |   |
+   +   +   +   +   +---+---+---+   +---+   +   +   +   +   +   +
|   |   |   |   |   |           |   |       |   |   |   |   |   |
+   +   +   +   +   +   +---+   +   +   +   +   +   +   +   +   +
|   |   |   |   |       |       |       |   |       |   |   |   |
+   +   +   +   +---+---+   +---+   +---+---+   +   +   +   +   +
|       |   |                   |           |   |   |       |   |
+   +   +   +   +---+---+   +---+   +---+---+---+---+---+   +   +
|   |   |                       |                           |   |
+   +   +---+---+---+---+---+---+---+---+---+---+---+---+---+   +
|   |                                                           |
.---+---+---+---+---+---+---+---+---+---+---+---+---+---+---+---+
