+---+---+---+---+---+---+---+---+---+---+---+---+---+---+---+---+
|                                                               |
+   +---+---+---+---+---+---+---+---+---+---+---+---+---+---+   +
|   |                                                           |
+   +   +---+---+---+---+---+---+---+---+---+---+---+---+---+   +
|   |   |               |       |       |                   |   |
+   +   +   +---+   +---+   +   +   +   +   +---+---+---+   +   +
|   |   |   |   |           |   |   |   |   |       |       |   |
+   +   +   +   +---+---+---+   +   +   +   +---+   +   +---+   +
|   |   |   |                   |   |   |   |           |       |
+   +   +   +   +---+---+---+   +   +   +   +---+   +---+   +   +
|   |   |   |   |       |   |   |   |       |       |   |   |   |
+   +   +   +   +   +   +   +---+   +---+---+   +---+   +   +   +
|   |   |   |       |   |           |               |       |   |
+   +   +   +---+---+   +   +---+---+---+   +---+---+   +   +   +
|   |   |   |           |   |       |           |   |   |   |   |
+   +   +   +   +   +---+   +   +   +   +---+---+   +   +   +   +
|   |   |   |   |   |       |                   |       |   |   |
+   +   +   +   +---+   +---+---+---+---+---+   +   +   +   +   +
|   |   |   |   |           |               |   |   |   |   |   |
+   +   +   +   +   +---+---+---+---+   +   +   +   +---+---+   +
|   |   |   |   |       |               |   |   |           |   |
+   +   +   +   +   +   +   +---+   +---+   +   +---+---+   +   +
|   |   |   |       |   |               |   |           |   |   |
+   +   +   +---+---+   +---+   +---+   +   +---+---+   +   +   +
|   |       |           |               |   |       |   |   |   |
+   +---+   +   +---+---+   +---+   +---+   +   +   +   +   +   +
|       |   |                           |       |       |   |   |
+   +   +   +---+---+---+---+---+---+---+---+---+---+---+   +   +
|   |   |                                                   |   |
+   +   +---+---+---+---+---+---+---+---+---+---+---+---+---+   +
|   |                                                           |
.---+---+---+---+---+---+---+---+---+---+---+---+---+---+---+---+
