+---+---+---+---+---+---+---+---+---+---+---+---+---+---+---+---+
|   |                                                           |
+   +   +   +---+---+---+---+---+---+---+---+---+---+   +   +---+
|       |   |               |                                   |
+   +---+   +   +---+---+   +   +---+---+   +   +   +---+---+   +
|           |   |       |       |       |       |               |
+   +---+   +   +   +   +---+---+   +   +---+---+---+---+   +   +
|           |       |                                           |
+   +---+---+---+---+---+---+---+---+---+---+---+   +   +---+   +
|   |       |       |           |                               |
+   +   +   +---+   +   +   +   +   +   +   +   +---+---+   +   +
|   |   |       |       |   |           |       |               |
+   +   +---+---+---+---+---+---+---+---+---+---+---+   +---+   +
|   |       |           |               |       |               |
+   +---+   +   +   +---+   +   +---+   +   +   +---+   +---+   +
|   |       |   |       |   |                                   |
+   +   +---+   +---+   +   +   +   +---+---+---+---+   +---+   +
|   |   |       |       |   |           |                       |
+   +   +   +---+   +---+   +---+---+   +   +   +---+---+---+   +
|   |       |           |                                       |
+   +---+---+   +---+---+---+---+---+---+---+---+---+---+   +   +
|   |           |       |   |           |                       |
+   +   +   +   +   +   +   +   +   +   +   +   +   +   +   +   +
|   |       |       |           |               |               |
+   +---+   +   +---+---+   +---+---+   +---+   +   +---+   +   +
|   |       |       |   |   |           |       |               |
+   +   +   +   +   +   +   +   +   +   +   +   +   +   +   +   +
|   |   |           |           |               |               |
+   +   +   +---+---+   +---+---+---+---+---+   +   +   +   +   +
|       |   |   |   |                                           |
+   +   +   +   +   +   +   +   +   +   +   +   +   +   +   +   +
|   |                                                           |
.---+---+---+---+---+---+---+---+---+---+---+---+---+---+---+---+
