+---+---+---+---+---+---+---+---+---+---+---+---+---+---+---+---+
|                                                               |
+   +---+---+---+---+---+---+---+---+---+---+---+---+---+---+   +
|   |                                                           |
+   +   +---+---+---+---+---+---+---+---+---+---+---+---+   +   +
|   |               |       |               |           |   |   |
+   +   +---+---+   +   +   +   +---+---+   +   +---+   +   +   +
|   |   |           |   |       |       |   |       |   |   |   |
+   +   +   +   +---+   +---+---+   +   +   +---+   +   +   +   +
|   |   |   |   |       |   |       |   |   |       |   |   |   |
+   +   +   +---+   +---+   +   +---+   +   +   +---+   +   +   +
|   |   |   |       |   |           |   |   |       |   |   |   |
+   +   +   +   +---+   +   +---+   +   +   +---+   +   +   +   +
|   |   |   |   |   |               |       |       |   |   |   |
+   +   +   +   +   +   +---+---+---+---+---+---+   +   +   +   +
|   |   |       |           |       |               |   |   |   |
+   +   +---+---+   +---+   +   +   +   +---+   +   +   +   +   +
|   |   |                   |       |           |   |   |   |   |
+   +   +   +---+---+---+---+---+   +---+   +   +---+   +   +   +
|   |   |       |                   |       |   |       |   |   |
+   +   +---+   +   +---+   +---+---+   +   +---+   +---+   +   +
|   |   |       |       |   |           |   |       |   |   |   |
+   +   +   +---+   +   +---+---+   +   +---+   +---+   +   +   +
|   |   |       |   |   |   |       |   |       |       |   |   |
+   +   +---+   +   +---+   +   +---+---+   +---+   +   +   +   +
|   |       |       |       |       |       |       |   |   |   |
+   +---+   +   +---+   +   +---+   +   +---+   +---+   +   +   +
|       |   |           |           |           |       |   |   |
+   +   +   +---+---+---+---+---+---+---+---+---+---+   +   +   +
|   |   |                                                   |   |
+   +   +---+---+---+---+---+---+---+---+---+---+---+---+---+   +
|   |                                                           |
.---+---+---+---+---+---+---+---+---+---+---+---+---+---+---+---+
