+---+---+---+---+---+---+---+---+---+---+---+---+---+---+---+---+
|                                                               |
+   +---+---+---+---+---+---+---+---+---+---+---+---+---+---+   +
|   |                                                           |
+   +   +---+---+---+---+---+---+---+---+---+---+---+---+---+   +
|   |   |                                                       |
+   +   +   +   +---+---+   +---+---+---+---+---+---+---+---+   +
|   |   |   |           |               |   |       |           |
+   +   +   +---+---+   +---+---+---+   +   +   +   +   +   +   +
|   |   |               |               |   |   |   |   |   |   |
+   +   +   +---+   +---+   +---+---+---+   +   +   +   +---+   +
|   |   |   |           |                   |   |   |       |   |
+   +   +   +   +   +---+---+---+---+---+   +   +   +---+   +   +
|   |   |   |   |   |   |               |   |   |   |       |   |
+   +   +   +   +---+   +   +---+---+   +   +   +   +   +---+   +
|   |   |   |       |   |   |       |   |   |   |   |       |   |
+   +   +   +---+   +   +   +   +   +   +   +   +   +---+   +   +
|   |   |   |           |           |   |       |       |   |   |
+   +   +   +   +---+   +   +---+---+   +   +   +---+   +   +   +
|   |   |   |   |       |               |   |       |       |   |
+   +   +   +---+   +   +---+---+   +---+---+   +   +---+   +   +
|   |   |   |       |   |   |       |       |   |       |   |   |
+   +   +   +   +   +---+   +   +---+   +   +---+---+   +---+   +
|   |   |   |   |   |   |       |       |   |               |   |
+   +   +   +   +---+   +   +---+   +---+   +---+---+---+   +   +
|   |   |   |           |               |   |       |       |   |
+   +   +   +---+   +---+---+---+---+---+   +   +   +   +   +   +
|       |   |                                   |       |   |   |
+   +   +   +---+---+---+---+---+---+---+---+---+---+---+   +   +
|   |   |                                                   |   |
+   +   +---+---+---+---+---+---+---+---+---+---+---+---+---+   +
|   |                                                           |
.---+---+---+---+---+---+---+---+---+---+---+---+---+---+---+---+
