+---+---+---+---+---+---+---+---+---+---+---+---+---+---+---+---+
|                                       |                       |
+---+---+---+---+---+   +---+---+---+   +   +---+   +---+---+   +
|                       |           |   |   |   |   |   |   |   |
+   +---+---+---+---+---+---+---+---+   +---+---+   +   +   +   +
|   |                                               |   |   |   |
+   +   +---+---+   +---+---+---+---+---+---+---+---+   +---+   +
|   |   |       |   |                   |               |       |
+   +   +   +   +   +   +---+---+---+   +   +---+---+   +   +---+
|   |   |       |   |   |           |   |   |   |   |   |   |   |
+   +   +---+---+   +   +---+---+---+   +   +   +   +   +   +   +
|   |   |           |                   |   |   |   |   |   |   |
+   +   +---+---+---+---+---+---+---+---+   +   +   +   +   +   +
|   |                                       |   |   |       |   |
+   +---+---+---+---+---+   +---+---+   +   +   +   +   +---+   +
|                       |   |       |   |   |   |   |   |   |   |
+---+---+---+   +---+---+   +   +   +   +   +   +   +   +   +   +
|   |       |   |           |       |   |   |   |   |   |   |   |
+   +---+---+   +   +---+---+---+   +   +   +   +   +   +   +   +
|               |   |                   |   |   |   |   |   |   |
+   +---+---+---+   +---+---+---+---+---+---+   +---+   +---+   +
|   |                               |                           |
+   +   +---+---+---+---+---+---+   +   +---+---+---+---+---+   +
|   |   |                       |   |   |                   |   |
+   +   +---+---+---+---+---+---+   +   +---+---+---+---+---+   +
|   |                                   |                       |
+   +---+---+---+---+   +---+---+---+   +---+---+---+---+---+---+
|   |               |   |           |                           |
+   +---+---+---+---+---+---+---+---+---+---+---+---+---+---+   +
|                                                       |   |   |
+   +---+---+   +---+---+---+---+---+---+---+---+---+   +---+   +
|   |       |                       |                           |
+---+---+---+---+---+---+---+---+---+---+---+---+---+---+---+---+
