+---+---+---+---+---+---+---+---+---+---+---+---+---+---+---+---+
|                       |                                       |
+   +---+   +---+---+---+   +---+   +---+   +---+---+---+---+   +
|   |   |                   |   |   |   |   |               |   |
+   +---+---+---+   +---+---+---+   +---+   +---+---+---+---+   +
|                   |                                           |
+   +---+---+   +---+   +---+---+---+---+---+---+---+   +---+   +
|   |       |   |   |           |   |                   |   |   |
+   +   +   +   +   +   +---+---+---+---+   +---+---+   +   +   +
|   |   |   |   |   |   |               |   |   |   |   |   |   |
+   +   +   +   +   +   +   +---+---+   +   +   +---+   +---+   +
|   |   |   |   |       |   |       |   |   |                   |
+   +   +   +---+   +   +   +---+---+   +   +   +---+---+---+   +
|   |   |       |   |   |               |   |   |           |   |
+   +   +---+   +   +   +---+---+---+---+   +   +---+---+   +   +
|           |   |   |               |       |           |   |   |
+   +---+   +   +   +---+---+   +   +---+---+   +---+   +   +   +
|   |   |   |   |           |                   |   |   |   |   |
+---+---+   +   +   +---+   +---+---+---+---+---+   +   +   +   +
|           |   |   |   |                           |   |   |   |
+   +---+   +   +   +---+---+---+---+---+---+---+   +   +   +   +
|   |   |   |   |                                   |   |       |
+   +---+---+   +---+---+---+---+---+---+---+---+   +   +---+   +
|           |                                   |   |       |   |
+   +---+   +   +---+   +---+---+---+---+---+   +   +   +   +   +
|   |   |   |   |   |                           |   |   |   |   |
+   +   +   +   +---+---+---+---+---+---+---+   +   +   +   +   +
|   |   |   |                           |   |   |       |   |   |
+   +   +   +   +   +---+   +---+   +   +---+   +---+---+   +   +
|   |   |   |   |   |   |   |   |   |                       |   |
+   +---+   +---+   +---+   +---+   +---+---+---+---+---+---+   +
|   |                   |                                       |
+---+---+---+---+---+---+---+---+---+---+---+---+---+---+---+---+
