+---+---+---+---+---+---+---+---+---+---+---+---+---+---+---+---+
|   |                                                           |
+   +   +---+---+---+---+---+---+---+   +---+---+   +---+---+   +
|   |   |                                                   |   |
+   +   +---+---+---+---+---+   +---+---+---+   +---+---+   +   +
|       |                                   |           |   |   |
+   +---+   +---+---+---+---+---+---+---+   +---+---+   +   +   +
|       |   |           |                           |   |   |   |
+   +   +   +   +---+---+---+---+---+---+---+---+---+   +   +   +
|   |   |   |   |               |               |   |   |   |   |
+   +   +   +   +   +---+---+---+---+---+---+   +   +   +   +   +
|   |   |   |   |   |           |           |   |   |   |       |
+   +   +   +   +   +   +---+---+---+---+   +   +   +   +   +   +
|   |   |   |   |   |   |               |   |       |   |   |   |
+   +   +   +   +   +   +   +---+---+   +   +   +   +   +   +   +
|   |   |   |   |   |   |   |       |   |   |   |   |   |   |   |
+   +   +   +   +   +   +   +   A   +   +   +   +   +   +   +   +
|   |   |               |           |   |       |   |   |   |   |
+   +   +   +   +   +   +---+---+---+   +   +   +   +   +   +   +
|   |   |   |   |   |   |               |   |   |   |       |   |
+   +   +   +   +   +   +---+---+   +---+   +   +   +   +   +   +
|   |   |   |   |   |   |                   |   |   |   |   |   |
+   +   +   +   +---+---+---+---+---+---+---+   +   +   +   +   +
|   |   |   |   |                               |   |   |       |
+   +   +   +   +---+---+---+---+   +---+---+---+   +   +   +   +
|       |   |                                       |   |   |   |
+   +---+   +---+---+---+---+---+---+---+---+---+---+   +   +   +
|       |                                           |   |   |   |
+   +   +---+---+---+---+---+---+   +---+---+---+---+---+---+   +
|   |   |                       |                               |
+   +   +---+---+   +---+---+---+---+---+---+---+---+---+---+   +
|||||                                                           |
+---+---+---+---+---+---+---+---+---+---+---+---+---+---+---+---+
