+---+---+---+---+---+---+---+---+---+---+---+---+---+---+---+---+
|   |                       |                                   |
+   +   +---+   +---+   +---+   +---+---+---+---+---+   +   +   +
|   |       |               |                       |   |   |   |
+   +   +   +   +---+   +---+---+---+---+---+---+   +   +   +   +
|   |   |   |                                       |       |   |
+   +   +   +---+---+---+---+---+---+---+---+---+---+   +---+   +
|       |   |                                       |   |       |
+   +   +   +   +---+   +---+   +---+---+---+---+   +   +   +---+
|   |   |   |                       |               |   |   |   |
+   +   +   +   +---+   +---+   +---+   +   +   +---+   +   +   +
|   |   |   |                       |   |   |   |   |   |       |
+   +   +   +   +---+   +---+---+---+   +   +   +   +   +---+   +
|       |   |           |           |   |   |   |   |   |   |   |
+   +   +   +---+---+   +   +---+   +   +   +   +   +   +   +   +
|   |   |       |           |       |               |   |       |
+   +   +   +---+---+   +   +   +   +   +   +   +   +   +   +   +
|   |   |           |   |   |       |   |   |   |   |   |   |   |
+   +   +---+   +---+---+   +---+---+   +   +   +   +   +   +   +
|       |               |   |           |   |   |   |   |   |   |
+   +   +   +---+   +---+---+   +---+   +   +   +   +   +   +   +
|   |   |               |   |                       |   |       |
+   +   +   +   +---+   +   +---+---+---+---+---+   +   +   +   +
|   |   |   |       |       |       |       |   |   |   |   |   |
+   +   +---+---+   +   +   +   +   +   +   +   +   +   +   +   +
|   |           |       |       |       |           |   |   |   |
+   +---+---+   +---+   +   +   +   +   +   +   +---+   +   +   +
|           |   |           |       |       |           |       |
+   +---+   +   +---+---+---+---+---+---+---+---+---+---+---+   +
|   |   |   |                                                   |
+   +   +   +---+---+---+   +---+---+   +---+---+---+---+   +   +
|   |                                                       |   |
+---+---+---+---+---+---+---+---+---+---+---+---+---+---+---+---+
