+---+---+---+---+---+---+---+---+---+---+---+---+---+---+---+---+
|                               |               |               |
+   +   +---+   +---+---+---+   +   +---+---+   +   +   +---+   +
|   |   |   |   |               |           |       |   |       |
+   +   +   +   +---+---+---+   +   +   +   +   +   +   +---+   +
|   |   |   |                   |   |   |   |   |   |           |
+   +   +   +   +---+---+---+   +   +   +   +   +   +---+---+---+
|   |   |   |   |               |       |   |   |               |
+   +---+   +   +---+---+---+   +---+---+   +   +---+---+---+   +
|                           |               |                   |
+   +---+---+---+---+---+---+---+---+---+---+---+---+---+---+   +
|   |               |                       |               |   |
+   +---+---+---+   +   +---+   +---+---+   +   +---+---+   +   +
|               |   |   |               |   |   |       |   |   |
+   +   +---+   +   +   +   +   +---+   +   +   +   +---+   +   +
|   |   |   |   |   |   |   |       |   |   |   |           |   |
+   +   +   +   +   +   +   +   +   +   +   +   +---+---+---+   +
|   |   |   |   |   |   |   |       |   |   |                   |
+   +---+   +---+   +   +   +---+---+   +   +---+---+---+---+   +
|                   |                               |       |   |
+---+---+---+   +---+---+---+---+---+---+---+---+   +   +   +   +
|                       |                           |   |   |   |
+   +---+---+   +---+---+---+---+   +---+---+   +---+   +   +   +
|   |                           |   |                           |
+   +   +---+   +   +---+   +   +   +---+---+---+---+---+   +   +
|   |   |   |   |   |   |   |   |                       |   |   |
+   +   +   +   +   +   +   +   +   +---+---+---+---+---+   +   +
|   |   |   |   |   |   |   |   |                           |   |
+   +   +   +   +   +   +   +   +   +---+---+---+---+---+   +   +
|   |   |   |   |   |   |   |   |   |                       |   |
+   +   +   +---+   +   +---+   +   +---+---+---+---+---+---+   +
|   |                           |                               |
+---+---+---+---+---+---+---+---+---+---+---+---+---+---+---+---+
