+---+---+---+---+---+---+---+---+---+---+---+---+---+---+---+---+
|                                                               |
+   +---+---+---+---+---+---+---+---+---+---+---+---+---+---+   +
|   |                                                       |   |
+   +   +---+---+---+---+   +   +---+---+---+---+---+---+   +   +
|   |   |               |   |                           |   |   |
+   +   +   +---+---+   +   +   +---+---+   +---+---+   +   +   +
|   |   |   |       |   |   |   |                   |   |       |
+   +   +   +   +   +   +   +   +---+---+---+---+   +   +   +---+
|   |   |   |   |   |   |   |                       |   |   |   |
+   +   +   +   +   +   +   +---+---+---+---+   +---+   +   +   +
|   |   |   |   |   |   |   |               |           |   |   |
+   +   +   +   +   +   +   +   +---+---+   +---+---+   +   +   +
|   |   |   |   |   |   |       |                   |       |   |
+   +   +   +   +   +   +   +---+   +   +---+---+   +---+---+   +
|   |   |   |   |   |   |   |       |   |       |   |           |
+   +   +   +   +   +   +   +   +   +   +   +   +   +---+   +---+
|   |           |   |   |   |       |   |   |   |       |       |
+   +---+---+---+   +   +   +---+---+   +   +   +---+   +---+   +
|   |           |   |   |               |           |   |       |
+   +   +   +---+   +   +---+---+---+---+---+---+   +   +   +---+
|   |   |           |   |                           |   |       |
+   +   +---+---+---+   +   +---+---+   +---+   +---+   +---+   +
|   |       |           |                                       |
+   +   +   +   +---+---+---+---+---+---+   +---+   +---+   +---+
|       |       |                       |                       |
+---+   +   +---+   +---+---+---+---+   +---+   +---+   +---+   +
|       |   |       |               |       |                   |
+   +   +   +   +---+   +---+---+   +---+   +---+   +---+   +---+
|   |   |       |           |           |       |               |
+   +   +   +---+---+---+   +   +---+---+---+   +---+---+---+   +
|   |                       |                                   |
+---+---+---+---+---+---+---+---+---+---+---+---+---+---+---+---+
