+---+---+---+---+---+---+---+---+---+---+---+---+---+---+---+---+
|                                                               |
+   +---+---+---+---+---+---+   +---+---+---+---+---+---+---+   +
|   |                                                       |   |
+   +   +---+---+---+---+---+---+---+---+---+---+---+   +   +   +
|   |   |                                               |   |   |
+   +   +   +---+---+---+---+---+---+---+   +---+---+   +   +   +
|   |   |   |                                       |   |   |   |
+   +   +   +   +---+---+---+---+---+---+---+---+   +   +   +   +
|   |   |   |   |                               |   |   |   |   |
+   +   +   +   +   +---+---+---+---+---+---+   +   +   +   +   +
|   |   |   |   |   |                       |   |   |   |   |   |
+   +   +   +   +   +   +---+---+   +---+   +   +   +   +   +   +
|   |   |   |   |   |   |               |   |   |   |   |   |   |
+   +   +   +   +   +   +   +---+---+   +   +   +   +   +   +   +
|       |   |   |   |   |   |       |   |   |   |   |           |
+   +   +   +   +   +   +   +   +   +   +   +   +   +   +   +   +
|   |   |   |       |   |   |       |   |   |   |   |   |   |   |
+   +   +   +   +   +   +   +   +---+   +   +   +   +   +   +   +
|   |   |   |   |   |   |   |           |       |   |   |   |   |
+   +   +   +   +   +   +   +---+---+---+   +   +   +   +   +   +
|   |   |   |   |   |   |                   |   |   |   |   |   |
+   +   +   +   +   +   +---+---+---+---+---+   +   +   +   +   +
|   |   |   |   |   |                           |   |   |   |   |
+   +   +   +   +   +---+---+---+   +---+---+---+   +   +   +   +
|   |   |   |   |                                   |   |   |   |
+   +   +   +   +---+---+---+---+---+---+---+---+---+   +   +   +
|   |   |   |                                           |   |   |
+   +   +   +---+---+---+---+---+---+---+---+---+---+---+   +   +
|       |                                                   |   |
+   +   +---+---+---+---+---+---+   +---+---+---+---+---+---+   +
|   |                                                           |
+---+---+---+---+---+---+---+---+---+---+---+---+---+---+---+---+
