+---+---+---+---+---+---+---+---+---+---+---+---+---+---+---+---+
|                                               |               |
+   +---+---+---+---+---+---+   +---+   +   +   +   +   +   +   +
|   |                   |   |   |       |   |   |   |   |   |   |
+   +---+   +   +   +   +   +   +---+   +   +   +---+   +   +   +
|   |   |   |   |   |   |   |   |       |   |           |   |   |
+   +   +   +   +   +   +   +   +---+---+---+   +---+---+---+   +
|   |   |   |   |   |   |   |                               |   |
+   +   +   +   +   +   +   +   +---+---+---+   +---+---+   +   +
|   |       |   |   |   |   |   |                           |   |
+   +   +   +   +   +   +   +   +---+---+---+   +---+---+   +   +
|   |   |   |               |   |                           |   |
+   +   +   +   +   +   +   +   +   +---+---+   +---+---+   +   +
|   |   |   |   |   |   |   |   |                           |   |
+   +---+   +   +   +   +   +---+---+---+---+---+---+---+---+   +
|               |   |   |   |       |                       |   |
+   +---+   +   +   +   +   +   +   +---+---+---+---+---+   +   +
|   |   |   |   |   |   |   |       |                           |
+   +   +   +   +   +   +   +   +---+---+---+---+---+---+---+   +
|   |   |   |   |   |   |   |                               |   |
+   +   +   +   +   +   +   +   +---+---+---+   +---+---+   +   +
|   |   |   |               |   |                           |   |
+   +   +   +   +   +   +   +   +---+---+---+   +---+---+   +   +
|   |       |   |   |   |   |   |                               |
+   +   +   +   +   +   +   +   +---+---+---+   +---+---+   +   +
|   |   |   |   |   |   |       |                           |   |
+   +   +   +   +   +   +   +   +   +---+---+   +---+---+---+   +
|   |   |   |   |   |   |   |           |   |           |   |   |
+   +---+   +   +   +   +   +   +   +---+   +   +---+   +   +   +
|   |                       |   |       |   |   |   |   |   |   |
+   +   +---+---+---+---+---+---+---+---+   +---+   +   +   +   +
|   |                                                           |
+---+---+---+---+---+---+---+---+---+---+---+---+---+---+---+---+
