+---+---+---+---+---+---+---+---+---+---+---+---+---+---+---+---+
|                               |               |               |
+   +---+---+---+---+---+---+   +---+   +   +   +   +   +   +   +
|   |                   |   |           |   |   |   |   |   |   |
+   +---+   +   +   +   +   +   +---+   +   +   +---+   +   +   +
|   |   |   |   |   |   |   |           |   |           |   |   |
+   +   +   +   +   +   +   +   +---+---+---+   +---+---+---+   +
|   |   |   |   |   |   |   |                               |   |
+   +   +   +   +   +   +   +   +---+---+---+   +---+---+   +   +
|   |       |   |   |   |   |                               |   |
+   +   +   +   +   +   +   +   +---+---+---+   +---+---+   +   +
|   |   |   |               |                               |   |
+   +   +   +   +   +   +   +   +---+---+---+   +---+---+   +   +
|   |   |   |   |   |   |   |                               |   |
+   +---+   +   +   +   +   +---+---+---+---+---+---+---+---+   +
|               |   |   |   |       |                       |   |
+   +---+   +   +   +   +   +   +   +---+---+---+---+---+   +   +
|   |   |   |   |   |   |   |       |                           |
+   +   +   +   +   +   +   +   +---+---+---+---+---+---+---+   +
|   |   |   |   |   |   |   |   |                           |   |
+   +   +   +   +   +   +   +   +---+---+---+   +---+---+   +   +
|   |   |   |               |   |                           |   |
+   +   +   +   +   +   +   +   +---+---+---+   +---+---+   +   +
|   |       |   |   |   |   |   |                               |
+   +   +   +   +   +   +   +   +---+---+---+   +---+---+   +   +
|   |   |   |   |   |   |   |   |                           |   |
+   +   +   +   +   +   +   +   +---+   +   +   +---+---+---+   +
|   |   |   |   |   |   |   |           |   |           |   |   |
+   +---+---+   +   +   +   +   +---+   +   +   +---+   +   +   +
|   |                   |   |   |       |   |       |   |   |   |
+   +   +---+---+---+---+---+---+---+---+---+---+   +   +   +   +
|   |                                                           |
+---+---+---+---+---+---+---+---+---+---+---+---+---+---+---+---+
