+---+---+---+---+---+---+---+---+---+---+---+---+---+---+---+---+
|                               |                               |
+   +---+---+---+---+---+---+   +   +---+---+---+   +   +---+   +
|   |                                               |       |   |
+   +   +   +---+---+---+---+---+---+---+---+---+   +---+   +---+
|   |   |                                       |       |       |
+   +   +   +---+---+---+---+---+---+---+---+   +---+   +---+   +
|   |   |   |                               |       |       |   |
+   +   +   +   +---+---+---+---+---+---+   +---+   +---+   +   +
|   |   |   |   |                                               |
+   +   +   +   +   +---+---+---+---+   +---+   +---+---+---+   +
|   |   |   |       |               |       |       |           |
+   +   +   +   +   +   +---+---+   +   +   +---+   +   +   +   +
|   |   |   |   |       |       |       |       |       |   |   |
+   +   +   +   +   +   +   +   +---+   +---+   +   +   +   +   +
|       |   |   |   |   |   |       |       |   |   |   |       |
+---+   +   +   +   +   +   +   +   +   +   +   +   +   +   +---+
|       |   |   |   |       |       |   |   |   |   |   |       |
+   +   +   +   +   +---+   +---+---+   +   +   +   +   +   +   +
|   |   |       |       |               |   |   |   |   |   |   |
+   +   +   +   +---+   +---+   +---+---+   +   +   +   +   +   +
|   |   |   |       |       |               |   |   |   |   |   |
+   +   +   +---+   +   +   +---+---+   +---+   +   +   +   +   +
|   |   |       |       |                       |   |   |   |   |
+   +   +---+   +---+   +---+---+---+---+   +---+   +   +   +   +
|   |       |       |                               |   |   |   |
+   +---+   +---+   +   +---+---+---+---+---+   +---+   +   +   +
|       |       |   |                                   |   |   |
+---+   +---+   +   +---+---+---+---+---+---+---+   +---+   +   +
|       |   |                                   |           |   |
+   +   +   +---+---+---+---+   +   +---+---+---+---+   +---+   +
|   |                           |                               |
+---+---+---+---+---+---+---+---+---+---+---+---+---+---+---+---+
