+---+---+---+---+---+---+---+---+---+---+---+---+---+---+---+---+
|                                                               |
+   +---+---+---+---+   +---+---+---+---+   +---+---+---+---+   +
|   |                                                       |   |
+   +   +---+---+---+---+---+---+---+---+---+---+---+---+   +   +
|   |   |                                               |   |   |
+   +   +   +---+   +---+---+---+---+---+---+   +---+   +   +   +
|   |   |   |       |                       |       |   |   |   |
+   +   +   +   +---+   +---+---+---+---+   +---+   +   +   +   +
|   |   |       |       |               |       |       |   |   |
+   +   +   +---+   +---+   +---+---+   +---+   +---+   +   +   +
|       |   |       |       |       |       |       |   |       |
+   +   +   +   +---+   +---+   +   +---+   +---+   +   +   +   +
|   |   |   |   |               |       |       |   |       |   |
+   +   +   +   +   +---+   +---+---+   +---+   +   +   +   +   +
|   |   |       |   |       |               |       |   |   |   |
+   +   +   +---+   +   +---+   +   +---+   +---+   +   +   +   +
|   |   |       |   |       |       |       |       |   |   |   |
+   +   +   +   +   +   +   +---+---+   +---+   +   +   +   +   +
|   |   |   |   |       |       |       |       |   |   |       |
+   +   +   +   +---+   +---+   +   +---+   +---+   +   +   +   +
|       |   |       |       |       |       |       |   |   |   |
+   +   +   +---+   +---+   +---+---+   +---+   +---+   +   +   +
|   |   |       |       |               |       |       |   |   |
+   +   +   +   +---+   +---+---+---+---+   +---+   +   +   +   +
|   |   |   |       |                       |       |   |   |   |
+   +   +   +---+   +---+---+---+---+---+---+   +---+   +   +   +
|   |   |   |   |                                       |   |   |
+   +   +   +---+---+---+---+---+---+---+---+---+---+---+   +   +
|   |   |                                                   |   |
+   +   +---+---+---+---+---+---+---+---+---+---+---+---+---+   +
|   |                                                           |
+---+---+---+---+---+---+---+---+---+---+---+---+---+---+---+---+
