+---+---+---+---+---+---+---+---+---+---+---+---+---+---+---+---+
|   |                                                           |
+   +   +   +---+---+---+---+---+---+---+---+---+---+---+---+   +
|   |   |   |   |       |                                   |   |
+   +   +   +   +   +   +---+---+---+---+---+---+---+   +   +   +
|   |   |   |   |   |                       |   |   |   |   |   |
+   +   +   +   +   +   +---+---+---+---+   +   +   +   +   +   +
|   |   |   |   |   |   |                   |   |   |   |   |   |
+   +   +   +   +   +   +   +---+---+---+---+   +   +   +   +   +
|       |   |   |   |   |                   |   |   |   |   |   |
+   +   +   +   +   +   +   +---+   +---+   +   +   +   +   +   +
|   |   |   |   |   |   |   |       |   |   |   |   |   |   |   |
+   +   +   +   +   +   +   +---+---+   +   +   +   +   +   +   +
|   |   |   |       |   |               |   |   |   |   |   |   |
+   +   +   +   +   +   +   +---+---+   +   +   +   +   +   +   +
|   |   |   |   |   |   |   |           |   |                   |
+   +   +   +   +   +   +   +   +   +   +   +---+   +   +---+   +
|       |   |   |   |   |   |       |   |   |       |       |   |
+   +   +   +   +   +   +   +---+---+---+   +---+   +   +---+   +
|   |   |       |   |   |                   |   |   |   |   |   |
+   +   +   +   +   +   +   +---+---+---+   +   +   +   +   +   +
|   |   |   |   |   |   |                           |       |   |
+   +   +   +   +   +   +---+---+---+---+---+---+---+---+   +   +
|   |   |   |   |   |                                   |   |   |
+   +   +   +---+   +---+---+---+---+---+   +---+---+   +   +   +
|       |                                               |   |   |
+   +   +   +---+---+---+---+---+   +---+---+---+---+---+   +   +
|   |   |                                                   |   |
+   +   +   +---+---+---+---+---+---+---+---+---+---+---+   +   +
|   |   |                                                   |   |
+   +   +---+---+---+---+---+---+   +---+---+---+---+---+---+---+
|   |                                                           |
+---+---+---+---+---+---+---+---+---+---+---+---+---+---+---+---+
