+---+---+---+---+---+---+---+---+---+---+---+---+---+---+---+---+
|                                                               |
+   +---+---+---+---+---+---+---+---+---+---+---+---+---+   +   +
|   |                                                   |   |   |
+   +   +---+---+---+---+---+---+---+---+   +---+---+   +   +   +
|   |   |                               |   |       |   |   |   |
+   +   +   +---+---+---+---+---+---+   +   +   +   +   +   +   +
|   |       |                           |   |   |   |   |   |   |
+   +---+---+   +---+---+---+---+---+---+   +   +   +   +   +   +
|   |   |       |       |               |   |   |   |   |   |   |
+   +   +   +---+   +   +   +---+---+   +   +   +   +   +   +   +
|   |       |       |   |   |           |   |   |   |   |   |   |
+   +   +---+   +---+   +   +   +---+   +   +   +   +   +   +   +
|   |           |       |   |       |       |   |   |   |   |   |
+   +---+---+---+   +---+   +---+---+   +---+   +   +   +   +   +
|               |       |           |   |   |   |   |   |   |   |
+   +---+---+   +---+   +   +   +   +   +   +   +   +   +   +   +
|   |       |           |   |       |   |       |   |   |   |   |
+   +   +   +---+---+---+   +---+---+   +   +---+   +   +   +   +
|   |   |               |       |       |       |   |   |   |   |
+   +   +---+---+   +---+---+   +   +---+---+   +   +   +   +   +
|   |           |       |       |           |   |   |   |   |   |
+   +---+---+   +---+   +   +---+---+---+   +   +   +   +   +   +
|   |       |       |   |               |   |   |   |   |   |   |
+   +   +   +---+   +   +---+---+   +   +   +   +   +   +   +   +
|       |   |       |               |       |   |   |   |   |   |
+---+   +   +   +---+---+---+---+---+---+---+   +   +   +---+   +
|       |   |                                   |   |           |
+   +   +   +---+---+---+---+---+---+---+---+---+   +---+---+---+
|   |   |                                                       |
+   +   +---+---+---+---+---+---+---+---+---+---+---+---+---+   +
|   |                                                           |
+---+---+---+---+---+---+---+---+---+---+---+---+---+---+---+---+
