+---+---+---+---+---+---+---+---+---+---+---+---+---+---+---+---+
|                                   |   |   |   |               |
+   +---+   +---+   +---+   +---+   +   +   +   +   +---+---+   +
|   |                       |       |       |   |   |       |   |
+   +---+---+---+---+---+   +   +   +   +   +   +   +   +   +   +
|   |                       |   |   |   |   |   |   |   |   |   |
+   +   +---+---+   +---+   +   +   +   +   +   +   +---+   +   +
|   |           |               |       |       |           |   |
+   +---+   +---+---+---+---+---+---+---+   +   +---+---+---+   +
|       |                               |   |                   |
+---+   +---+---+---+---+---+---+---+   +---+---+   +---+---+---+
|               |                           |                   |
+---+---+   +---+   +---+---+---+---+---+   +---+---+---+   +---+
|               |   |   |               |       |               |
+   +---+---+---+   +   +   +---+   +   +   +   +   +---+---+---+
|               |   |   |   |       |   |   |   |               |
+---+---+---+   +   +   +   +   +   +   +   +   +---+---+   +   +
|               |       |   |       |   |   |   |           |   |
+   +---+---+---+---+   +   +---+---+   +   +   +   +---+---+   +
|                   |                   |   |   |               |
+---+---+---+   +---+---+   +---+---+---+   +   +   +   +   +   +
|                       |               |   |   |   |   |   |   |
+   +---+---+   +---+   +---+   +---+---+   +   +   +   +   +---+
|           |   |   |   |   |               |   |       |       |
+   +---+   +   +   +   +   +---+---+---+---+   +---+   +   +   +
|       |   |   |   |       |       |   |   |   |   |   |   |   |
+---+---+   +---+   +   +   +   +   +   +   +   +   +   +   +   +
|                   |   |   |   |   |       |       |   |       |
+   +---+---+   +---+   +   +   +   +   +   +---+   +   +   +   +
|   |       |   |       |   |   |   |   |       |       |   |   |
+   +   +---+   +---+   +   +   +   +   +   +   +---+---+---+   +
|   |                   |       |       |   |                   |
+---+---+---+---+---+---+---+---+---+---+---+---+---+---+---+---+
