+---+---+---+---+---+---+---+---+---+---+---+---+---+---+---+---+
|       |       |   |                               |           |
+   +   +   +   +   +   +---+---+---+---+---+---+   +---+   +   +
|   |   |   |           |   |       |       |       |       |   |
+   +   +   +   +---+---+   +   +   +---+   +   +---+   +---+   +
|       |   |   |           |   |       |   |       |       |   |
+   +   +   +   +---+   +   +   +   +   +   +   +---+---+   +   +
|   |       |   |   |   |       |   |       |               |   |
+   +---+---+   +   +   +---+---+---+---+   +---+---+---+---+   +
|   |       |   |               |       |                   |   |
+   +   +   +   +---+   +   +   +   +---+---+   +---+---+   +   +
|   |   |   |           |   |   |   |                   |       |
+   +   +   +---+   +---+   +   +   +   +---+---+---+   +   +   +
|   |   |       |       |   |       |           |       |   |   |
+   +   +   +   +---+   +---+---+---+---+---+   +   +---+   +   +
|       |   |       |       |       |       |   |   |       |   |
+   +   +   +---+   +---+   +   +   +   +   +---+   +---+---+---+
|   |   |   |   |       |   |           |                       |
+   +   +   +   +---+   +   +---+---+---+---+---+---+---+---+   +
|       |   |       |   |       |                               |
+   +   +   +   +   +   +---+   +   +---+---+---+---+---+---+---+
|   |   |   |   |   |           |                               |
+   +   +   +   +   +   +---+---+---+---+---+   +---+---+---+---+
|       |   |   |   |           |               |               |
+   +   +   +   +   +   +---+---+---+---+---+   +   +   +   +   +
|   |   |   |   |   |       |                       |   |   |   |
+---+---+   +   +   +---+   +---+---+---+---+---+---+---+   +   +
|               |   |   |           |   |   |   |   |       |   |
+   +---+   +   +   +   +---+   +---+   +   +   +   +   +---+   +
|   |   |   |   |   |       |                                   |
+   +   +   +   +---+   +   +---+---+   +   +   +   +   +   +   +
|   |       |       |   |               |   |   |   |   |   |   |
+---+---+---+---+---+---+---+---+---+---+---+---+---+---+---+---+
