+---+---+---+---+---+---+---+---+---+---+---+---+---+---+---+---+
|                   |                           |               |
+   +---+---+---+   +   +---+---+---+---+   +   +   +---+---+   +
|               |   |           |           |       |       |   |
+---+   +---+   +   +---+   +---+   +---+   +   +   +   +   +   +
|       |       |                           |   |   |   |   |   |
+   +   +   +   +   +---+   +---+   +---+   +   +   +   +   +   +
|   |   |   |                                   |   |   |   |   |
+   +   +   +   +   +---+   +---+   +---+   +   +   +   +   +   +
|   |   |   |   |                           |   |   |   |   |   |
+   +   +---+   +---+---+   +---+   +---+   +   +   +   +   +   +
|   |           |               |   |       |   |   |   |   |   |
+   +---+---+   +---+   +---+---+---+---+---+---+   +   +   +   +
|   |       |   |   |   |                           |   |   |   |
+   +   +   +   +   +   +   +   +---+---+   +   +---+   +   +   +
|   |   |       |   |   |   |       |   |   |   |       |   |   |
+   +   +---+---+   +   +   +   +   +   +   +   +   +   +   +   +
|   |   |           |   |   |       |   |   |   |   |   |   |   |
+   +   +   +   +---+   +   +---+---+   +   +   +   +   +   +   +
|   |   |   |           |               |   |   |   |   |   |   |
+   +   +   +---+   +---+---+---+---+   +   +   +   +   +   +   +
|   |   |       |       |           |   |   |   |   |   |   |   |
+   +   +---+   +---+   +   +---+   +   +   +   +   +   +   +   +
|   |       |       |       |       |   |   |   |   |   |   |   |
+   +   +   +---+   +---+   +---+   +   +   +---+   +   +   +   +
|       |       |       |           |   |   |       |   |   |   |
+---+   +   +   +---+   +   +---+---+   +   +---+---+   +   +   +
|       |   |           |               |               |   |   |
+   +   +   +---+---+---+---+---+---+---+---+---+---+---+   +   +
|   |   |                           |                       |   |
+   +   +---+---+---+---+---+---+   +   +   +---+---+---+---+   +
|   |                                   |                       |
+---+---+---+---+---+---+---+---+---+---+---+---+---+---+---+---+
