+---+---+---+---+---+---+---+---+---+---+---+---+---+---+---+---+
|               |       |   |       |           |               |
+---+---+   +   +   +   +   +   +   +   +   +   +   +---+---+   +
|           |       |       |   |   |   |   |           |       |
+   +---+   +   +---+---+   +   +   +   +   +   +   +   +   +   +
|       |   |           |   |   |   |   |   |   |   |   |   |   |
+   +   +   +   +   +   +   +   +   +   +   +   +   +   +   +   +
|   |   |   |   |   |           |           |   |   |       |   |
+   +---+   +---+---+---+   +---+---+---+---+   +   +---+   +   +
|       |       |   |       |                   |       |       |
+   +   +---+   +   +   +---+   +   +   +   +---+---+   +---+---+
|   |   |       |       |   |   |   |   |           |           |
+---+   +   +---+   +---+   +   +   +   +   +---+---+---+---+   +
|       |                   |       |   |           |           |
+   +---+---+---+---+---+---+---+---+---+---+---+   +   +---+   +
|                       |           |               |       |   |
+   +---+---+---+---+---+   +   +   +   +---+---+   +---+   +---+
|   |                   |   |       |                   |       |
+   +   +---+---+---+   +   +---+---+---+---+   +   +   +   +---+
|   |   |               |   |   |       |   |   |   |   |   |   |
+   +   +---+---+---+   +   +   +   +   +   +   +---+---+   +   +
|   |               |       |       |       |           |   |   |
+   +   +---+   +---+---+---+   +---+   +   +   +---+   +   +   +
|   |   |                               |       |       |   |   |
+   +---+---+---+---+---+---+---+---+---+---+---+---+   +   +   +
|   |               |           |   |               |   |       |
+   +---+---+   +   +   +---+   +   +   +---+---+   +---+---+   +
|           |   |       |   |       |                   |   |   |
+   +---+   +   +---+---+   +   +---+---+---+---+---+   +   +   +
|   |   |   |       |               |                   |       |
+   +   +   +   +   +   +---+---+   +---+---+   +   +---+---+   +
|   |           |               |               |               |
+---+---+---+---+---+---+---+---+---+---+---+---+---+---+---+---+
