+---+---+---+---+---+---+---+---+---+---+---+---+---+---+---+---+
|                                   |                           |
+---+   +   +---+   +---+   +---+   +   +---+---+   +   +---+   +
|       |                       |           |       |       |   |
+   +---+---+---+   +---+---+---+   +---+   +   +---+---+   +   +
|   |                                                           |
+   +---+---+---+---+---+---+---+---+---+---+---+---+---+---+   +
|                                                               |
+   +---+---+---+---+---+---+---+---+---+---+---+---+---+---+   +
|   |                                                           |
+   +---+---+---+---+---+---+---+---+---+---+---+---+---+   +   +
|                           |       |       |       |       |   |
+   +---+---+---+   +---+---+   +   +   +   +   +   +   +---+   +
|   |                       |   |       |       |       |       |
+   +---+---+---+---+---+---+   +---+---+---+---+---+---+   +---+
|                           |       |               |       |   |
+   +---+---+---+---+---+   +   +   +---+---+---+   +   +---+   +
|   |       |               |       |               |       |   |
+---+   +   +   +---+   +   +---+---+   +---+---+---+   +   +   +
|   |   |               |                   |           |   |   |
+   +---+   +---+   +   +   +---+---+   +---+---+   +---+   +   +
|   |               |               |           |       |       |
+   +   +---+   +   +   +---+---+   +---+   +---+---+   +---+   +
|               |               |   |       |       |       |   |
+   +---+   +   +   +---+   +---+   +   +---+   +   +---+   +   +
|           |               |   |   |       |   |       |       |
+---+   +   +   +   +---+---+   +   +---+   +   +---+   +   +   +
|       |       |   |               |       |   |   |   |   |   |
+   +   +   +---+   +---+   +---+---+   +---+   +   +   +---+   +
|   |       |       |       |       |           |           |   |
+   +---+---+   +---+   +   +   +   +---+   +---+   +---+   +   +
|   |                   |       |                               |
+---+---+---+---+---+---+---+---+---+---+---+---+---+---+---+---+
