+---+---+---+---+---+---+---+---+---+---+---+---+---+---+---+---+
|                                                               |
+   +---+---+   +---+---+   +   +---+---+---+   +   +   +---+   +
|                           |   |           |   |   |   |   |   |
+   +---+---+---+---+---+   +---+   +---+   +   +   +   +   +   +
|                       |           |   |   |   |   |   |   |   |
+   +---+   +---+   +   +   +---+   +---+   +   +   +   +---+   +
|   |   |   |   |   |   |   |   |           |   |               |
+   +   +   +   +   +   +   +   +---+---+---+   +---+---+---+   +
|   |   |   |   |   |   |   |                                   |
+---+   +---+   +---+   +---+   +---+   +---+   +---+---+---+   +
|                       |       |           |   |           |   |
+   +---+   +---+   +---+---+   +---+---+---+   +   +---+   +   +
|   |   |   |   |   |   |                   |   |   |   |   |   |
+   +   +   +   +   +   +   +---+   +   +   +   +   +---+   +   +
|   |   |   |   |   |   |   |       |   |       |           |   |
+   +   +---+   +---+   +   +   +   +   +---+   +---+   +---+   +
|                       |   |       |   |           |           |
+---+---+   +---+---+---+   +---+---+   +   +---+---+   +---+   +
|                       |               |   |                   |
+   +---+---+---+---+   +---+---+---+---+---+---+---+---+   +   +
|   |                   |   |           |               |   |   |
+   +   +---+---+   +   +   +   +---+---+   +---+---+   +   +   +
|   |           |   |       |   |           |           |   |   |
+---+---+---+   +   +   +   +   +---+---+   +---+---+   +   +   +
|               |       |   |           |           |   |       |
+   +---+---+   +   +   +---+   +---+---+   +---+---+   +   +   +
|   |           |   |           |           |           |   |   |
+   +   +---+---+   +   +---+   +---+---+   +---+---+   +   +   +
|   |               |   |   |           |           |   |   |   |
+   +---+---+   +---+   +   +   +---+---+   +---+---+   +   +   +
|   |                   |                   |                   |
+---+---+---+---+---+---+---+---+---+---+---+---+---+---+---+---+
