+---+---+---+---+---+---+---+---+---+---+---+---+---+---+---+---+
|                                                           |   |
+   +---+---+---+---+---+---+---+---+---+   +   +   +   +   +   +
|   |                                   |   |   |   |   |       |
+   +   +---+---+---+---+---+---+---+   +   +---+---+---+   +---+
|   |                           |   |   |   |           |       |
+   +---+---+---+   +---+---+---+   +   +   +   +---+   +---+   +
|                               |       |   |               |   |
+   +---+---+---+---+---+---+   +   +   +   +   +   +---+   +   +
|                           |   |   |       |       |   |   |   |
+---+---+---+---+---+---+   +   +   +   +---+---+---+   +---+   +
|                           |   |   |                           |
+---+   +---+---+---+---+---+---+   +---+   +---+---+---+---+   +
|                       |       |                           |   |
+---+---+   +---+---+---+   +---+   +   +---+---+---+---+   +   +
|           |           |   |       |                   |   |   |
+---+   +---+   +---+   +   +   +   +---+---+---+---+---+   +   +
|       |       |       |   |       |   |               |   |   |
+   +---+   +---+   +---+   +---+---+   +---+---+   +   +   +   +
|   |       |       |                   |       |   |       |   |
+   +   +---+   +---+   +   +---+---+---+   +   +   +   +   +   +
|       |       |   |   |   |       |   |   |   |   |   |   |   |
+   +---+   +---+   +   +---+   +   +   +   +   +   +   +   +   +
|   |       |           |       |   |   |   |   |   |   |   |   |
+---+   +---+   +---+---+   +---+   +   +   +   +   +   +   +   +
|                   |       |       |   |   |   |   |   |   |   |
+---+---+   +   +---+   +---+   +---+   +   +   +   +   +   +   +
|           |   |       |       |       |   |   |   |   |   |   |
+   +   +   +   +   +---+   +---+   +   +   +   +   +   +   +   +
|   |   |   |       |       |       |       |   |   |       |   |
+   +---+   +   +---+   +---+   +   +   +   +   +   +---+---+   +
|   |       |   |               |   |   |   |                   |
+---+---+---+---+---+---+---+---+---+---+---+---+---+---+---+---+
