+---+---+---+---+---+---+---+---+---+---+---+---+---+---+---+---+
|       |       |       |                                       |
+   +   +   +   +   +---+   +   +   +---+---+---+---+---+---+   +
|   |       |               |   |                           |   |
+   +   +---+   +---+   +   +---+   +---+---+---+---+---+   +   +
|               |       |           |                       |   |
+   +---+   +   +   +   +---+---+---+   +---+---+---+---+---+   +
|   |       |       |                                       |   |
+   +   +   +   +   +---+   +---+---+---+---+---+---+---+   +   +
|       |       |       |                                   |   |
+   +   +   +   +---+---+   +---+---+---+---+---+---+---+---+   +
|   |       |               |                                   |
+   +   +   +---+   +---+---+   +---+---+---+---+---+---+---+   +
|       |       |           |   |       |       |       |       |
+   +---+---+---+---+   +   +   +---+   +   +   +   +   +   +   +
|                       |   |       |   |   |       |       |   |
+   +---+---+---+---+---+   +   +   +   +   +---+---+---+   +   +
|   |                   |   |       |   |               |   |   |
+   +   +---+---+---+   +---+---+---+   +---+---+---+   +   +   +
|   |   |               |                               |   |   |
+   +   +   +---+---+---+   +---+---+---+---+   +---+---+   +   +
|       |   |                               |               |   |
+---+   +   +   +---+---+---+---+---+---+   +---+---+---+---+   +
|       |   |   |                                           |   |
+   +   +   +   +   +---+---+---+---+---+---+---+---+---+   +   +
|   |   |   |   |                           |                   |
+   +   +   +   +---+---+---+---+---+---+   +   +---+---+---+   +
|   |   |   |                           |   |               |   |
+   +   +   +   +---+---+---+---+---+   +   +---+---+---+   +   +
|   |   |       |                       |   |               |   |
+   +   +---+---+   +   +---+---+---+---+   +   +---+---+---+---+
|   |               |                                           |
+---+---+---+---+---+---+---+---+---+---+---+---+---+---+---+---+
