+---+---+---+---+---+---+---+---+---+---+---+---+---+---+---+---+
|                       |                                       |
+   +---+   +   +---+---+   +   +   +---+---+---+---+---+---+   +
|   |       |               |   |                           |   |
+   +   +---+   +---+   +   +---+   +---+---+---+---+---+   +   +
|   |       |   |       |           |                       |   |
+   +---+   +   +   +   +---+---+---+   +---+---+---+---+---+   +
|   |       |       |   |                                   |   |
+   +   +---+---+   +---+   +---+---+---+---+---+---+---+   +   +
|   |   |       |       |                                   |   |
+   +   +   +   +---+---+   +---+---+---+---+---+---+---+---+   +
|   |       |               |                                   |
+   +   +   +---+   +---+---+   +---+---+   +---+---+---+---+---+
|       |       |           |   |       |       |       |       |
+---+   +---+---+---+   +   +   +---+   +   +   +   +   +   +   +
|                       |   |       |   |   |       |       |   |
+   +---+---+---+---+---+   +   +   +   +   +---+---+---+   +   +
|   |                   |   |       |   |               |   |   |
+   +   +---+---+---+   +---+---+---+   +---+---+---+   +   +   +
|   |   |               |                               |   |   |
+   +   +   +---+---+---+   +---+---+---+---+   +---+---+   +   +
|       |   |                               |               |   |
+---+   +   +   +---+---+---+---+---+---+   +---+---+---+   +   +
|       |   |   |                                           |   |
+   +   +   +   +   +---+---+---+---+---+---+---+---+---+   +   +
|   |   |   |   |                           |                   |
+   +   +   +   +---+---+---+---+---+---+   +   +---+---+---+   +
|   |   |   |                           |   |               |   |
+   +   +   +   +---+---+---+---+---+   +   +---+---+---+   +   +
|   |   |       |                       |   |               |   |
+   +   +---+---+   +   +---+---+---+---+   +   +---+---+---+   +
|   |               |                                           |
+---+---+---+---+---+---+---+---+---+---+---+---+---+---+---+---+
