+---+---+---+---+---+---+---+---+---+---+---+---+---+---+---+---+
|                                                       |       |
+   +---+---+---+---+   +---+---+---+---+---+---+---+---+   +   +
|   |                                                       |   |
+   +   +---+---+---+---+---+---+---+---+---+---+---+---+   +   +
|   |   |   |               |           |               |   |   |
+   +   +   +---+   +   +   +   +   +   +   +---+   +   +   +   +
|   |   |           |   |   |   |   |       |   |   |   |   |   |
+   +   +---+   +   +   +   +   +   +---+---+   +---+   +   +   +
|       |       |   |   |       |   |       |   |       |   |   |
+   +   +   +---+---+---+---+---+   +   +   +   +   +   +   +   +
|   |   |                       |   |   |   |   |   |   |   |   |
+   +   +---+---+---+   +   +---+   +   +   +   +   +---+   +   +
|   |   |           |   |   |       |               |   |   |   |
+   +   +   +---+---+   +   +   +---+   +   +---+---+   +   +   +
|   |   |           |       |       |   |       |   |   |   |   |
+   +   +   +---+---+---+   +   +   +   +---+---+   +   +   +   +
|   |   |               |   |       |   |   |       |   |   |   |
+   +   +---+---+   +   +   +---+---+   +   +   +   +   +---+   +
|   |   |           |           |       |       |       |       |
+   +   +   +---+---+   +---+---+   +---+---+   +---+   +   +   +
|   |   |               |   |               |       |       |   |
+   +   +   +---+   +---+   +---+---+---+   +---+   +   +   +   +
|   |   |       |       |                       |       |   |   |
+   +   +   +   +   +   +   +---+---+---+---+---+---+   +   +   +
|   |   |   |   |   |               |                   |   |   |
+   +   +   +   +---+   +   +---+---+   +---+---+   +---+   +   +
|   |   |   |       |   |               |               |   |   |
+   +   +   +---+---+---+---+---+---+---+---+---+---+   +   +   +
|   |   |                           |                           |
+   +   +---+---+---+---+---+---+   +---+---+---+---+---+---+   +
|   |                       |                                   |
+---+---+---+---+---+---+---+---+---+---+---+---+---+---+---+---+
