+---+---+---+---+---+---+---+---+---+---+---+---+---+---+---+---+
|                                                               |
+   +---+---+---+---+---+---+---+---+---+---+---+---+   +---+   +
|                               |                       |   |   |
+---+---+---+   +---+---+---+---+   +---+---+---+   +   +   +   +
|   |                           |                   |   |       |
+   +---+---+---+---+---+   +---+   +---+---+---+   +---+   +   +
|   |                       |   |                           |   |
+   +---+---+---+   +---+---+   +---+---+---+   +   +---+---+   +
|   |                       |       |       |   |           |   |
+   +---+   +---+---+---+---+   +   +   +   +   +   +---+   +   +
|           |                   |       |       |   |   |   |   |
+   +---+---+   +---+---+---+---+---+---+---+---+---+   +   +   +
|           |                                           |   |   |
+   +---+---+---+---+---+---+---+---+---+   +---+---+   +   +   +
|                           |       |           |       |   |   |
+   +---+---+---+---+---+---+   +   +   +---+---+   +---+   +   +
|                           |       |   |               |   |   |
+---+---+---+---+   +---+   +   +---+   +---+---+---+   +   +   +
|                   |   |   |           |       |       |   |   |
+   +---+---+   +---+   +   +---+---+---+   +   +   +---+   +   +
|               |       |   |   |   |   |   |   |       |   |   |
+---+---+   +---+   +---+   +   +   +   +   +   +---+   +   +   +
|           |       |       |   |   |       |   |   |       |   |
+---+   +---+   +---+   +   +   +   +   +   +   +   +---+---+   +
|       |       |       |   |   |   |   |   |       |           |
+   +---+   +---+   +   +   +   +   +   +   +   +   +   +   +   +
|           |       |   |   |   |   |   |   |   |   |   |   |   |
+---+   +---+   +   +   +   +   +   +   +   +   +   +   +   +   +
|       |       |   |   |   |   |   |   |   |   |   |   |   |   |
+   +   +   +   +   +   +   +   +   +   +---+---+   +   +   +   +
|   |       |   |       |                       |               |
+---+---+---+---+---+---+---+---+---+---+---+---+---+---+---+---+
