+---+---+---+---+---+---+---+---+---+---+---+---+---+---+---+---+
|                                                       |       |
+   +---+---+---+   +---+---+   +---+---+---+   +---+---+   +   +
|           |   |       |   |   |           |       |       |   |
+   +---+   +   +   +   +   +   +   +---+   +   +   +   +---+   +
|   |       |       |       |   |       |   |   |       |       |
+   +   +---+   +   +---+---+   +---+   +   +   +---+---+   +   +
|       |       |   |       |           |   |               |   |
+   +   +   +   +---+   +   +---+---+---+   +---+---+---+---+   +
|   |       |   |       |               |                       |
+---+   +   +---+   +---+   +---+---+   +---+---+---+---+---+   +
|       |   |           |   |                   |               |
+   +   +---+   +---+   +   +   +---+---+---+   +   +---+---+   +
|   |   |       |   |   |   |               |   |           |   |
+   +---+   +---+   +   +   +---+---+   +---+   +   +---+   +   +
|   |       |       |   |   |       |   |       |       |   |   |
+   +   +   +   +   +   +   +   +   +   +   +---+---+   +   +   +
|   |   |       |       |           |       |       |   |   |   |
+   +   +---+   +   +---+---+---+---+   +---+   +   +   +   +   +
|   |       |   |           |       |   |       |       |   |   |
+   +---+   +   +---+   +---+   +   +   +   +---+---+---+   +   +
|       |   |       |   |       |   |   |   |               |   |
+---+   +   +---+   +   +   +---+   +   +   +   +---+---+---+   +
|       |       |   |   |   |       |   |   |   |               |
+   +---+---+   +   +   +   +   +---+   +   +   +   +---+---+   +
|   |       |   |   |   |   |           |   |   |   |       |   |
+   +   +   +   +   +---+   +   +---+---+   +   +   +   +---+   +
|       |   |   |           |   |           |   |   |           |
+   +   +   +   +---+---+---+   +   +---+---+   +   +---+---+---+
|   |   |   |                   |               |               |
+   +   +   +---+---+   +---+---+---+---+---+   +---+---+---+   +
|   |       |                                                   |
+---+---+---+---+---+---+---+---+---+---+---+---+---+---+---+---+
