+---+---+---+---+---+---+---+---+---+---+---+---+---+---+---+---+
|                                                       |       |
+   +---+---+---+---+   +---+   +---+---+---+   +---+---+   +   +
|           |           |   |   |           |       |       |   |
+   +---+   +   +   +   +   +   +   +---+   +   +   +   +---+   +
|   |       |   |   |       |   |       |   |   |       |       |
+   +   +---+   +   +---+---+   +---+   +   +   +---+---+   +   +
|       |       |   |       |           |   |               |   |
+   +   +   +   +---+   +   +---+---+---+   +---+---+---+---+   +
|   |   |   |   |       |                                       |
+---+   +   +---+   +---+   +---+---+---+---+   +---+---+---+   +
|           |           |   |                   |               |
+   +---+---+   +---+   +   +   +---+---+---+   +   +---+---+   +
|       |       |   |   |   |               |   |           |   |
+   +---+   +---+   +   +   +---+---+   +---+   +   +---+   +   +
|   |       |       |   |   |       |   |       |       |   |   |
+   +   +   +   +   +   +   +   +   +   +   +---+---+   +   +   +
|   |   |       |       |           |       |       |   |   |   |
+   +   +---+   +   +---+---+---+---+   +---+   +   +   +   +   +
|   |       |   |           |       |   |       |       |   |   |
+   +---+   +   +---+   +---+   +   +   +   +---+---+---+   +   +
|       |   |       |   |       |   |   |   |               |   |
+---+   +   +---+   +   +   +---+   +   +   +   +---+---+---+   +
|       |       |   |   |   |       |   |   |   |               |
+   +---+---+   +   +   +   +   +---+   +   +   +   +---+---+   +
|   |       |   |   |   |   |   |       |   |   |   |       |   |
+   +   +   +   +   +---+   +   +   +---+   +   +   +   +---+   +
|       |   |   |           |   |           |   |   |           |
+   +   +   +   +---+---+---+   +   +---+---+   +   +---+---+---+
|   |   |   |                                   |               |
+   +   +   +---+---+---+---+---+---+---+---+   +   +---+---+   +
|   |                                               |           |
+---+---+---+---+---+---+---+---+---+---+---+---+---+---+---+---+
