+---+---+---+---+---+---+---+---+---+---+---+---+---+---+---+---+
|               |                                               |
+   +---+---+---+   +---+---+   +---+---+   +---+---+   +   +   +
|   |   |       |   |   |           |           |       |   |   |
+   +   +   +   +   +   +   +   +---+---+   +---+   +---+   +   +
|       |   |   |           |                           |   |   |
+   +   +   +   +   +   +   +   +---+---+   +---+---+---+   +   +
|   |   |   |       |   |   |   |   |       |   |       |   |   |
+   +   +   +   +   +   +---+---+   +   +   +   +---+   +   +   +
|   |   |   |   |   |                   |               |   |   |
+   +   +   +   +---+---+---+---+---+---+   +---+---+   +   +   +
|   |   |   |   |   |               |   |   |   |   |   |   |   |
+   +   +   +   +   +   +---+---+   +   +   +   +   +   +   +   +
|   |   |   |   |   |                   |   |   |       |   |   |
+   +   +   +   +   +   +---+---+---+   +   +   +   +   +   +   +
|   |   |   |   |   |       |           |   |   |   |   |   |   |
+   +   +   +   +   +---+   +   +   +---+---+   +   +   +   +---+
|   |   |   |   |   |       |       |       |   |   |   |       |
+   +   +   +   +   +   +---+---+---+   +   +   +   +   +---+   +
|   |   |   |   |   |       |           |   |   |   |   |       |
+   +   +   +   +   +---+   +   +---+---+---+   +   +   +   +   +
|   |   |   |   |   |       |                   |   |       |   |
+   +   +   +   +   +   +---+---+---+---+---+   +   +   +   +   +
|   |           |   |   |   |                   |   |   |   |   |
+   +   +   +   +   +   +   +   +---+---+---+---+   +   +   +   +
|   |   |   |   |   |                               |   |   |   |
+   +---+---+   +   +---+---+---+---+---+---+---+---+---+   +   +
|       |   |                                               |   |
+   +   +   +---+---+---+---+---+---+---+---+---+---+---+   +   +
|   |                   |       |       |                   |   |
+   +---+---+---+---+   +   +   +   +   +---+---+---+---+---+   +
|   |                       |       |                           |
+---+---+---+---+---+---+---+---+---+---+---+---+---+---+---+---+
