+---+---+---+---+---+---+---+---+---+---+---+---+---+---+---+---+
|                                               |               |
+   +   +---+---+---+---+---+---+---+---+   +   +   +---+---+   +
|   |   |       |       |       |       |   |   |   |       |   |
+   +   +   +   +   +   +   +   +   +   +   +   +   +---+   +   +
|   |       |       |       |       |   |   |   |           |   |
+   +---+---+---+---+---+---+---+---+   +   +   +---+---+---+   +
|   |                                   |   |                   |
+   +   +---+---+---+---+---+---+---+---+---+---+   +---+---+---+
|   |   |                           |                           |
+   +   +   +---+---+---+---+---+   +---+---+   +---+---+---+   +
|   |   |   |                       |                       |   |
+   +   +   +   +---+---+---+---+---+---+   +---+---+---+   +   +
|   |   |   |                   |               |           |   |
+   +   +   +---+---+---+   +---+---+   +---+---+   +---+---+   +
|   |   |   |           |   |       |       |                   |
+   +   +   +   +---+   +   +   +   +---+   +---+---+---+---+   +
|   |   |       |       |           |       |               |   |
+   +   +---+---+   +---+---+---+---+   +---+   +---+---+   +   +
|   |                                   |               |   |   |
+   +---+---+---+---+---+---+   +---+---+---+---+---+   +   +   +
|               |           |                           |   |   |
+---+   +---+   +   +---+   +---+---+---+---+---+---+---+   +   +
|           |   |           |                           |   |   |
+   +---+   +   +---+---+   +---+---+---+---+---+---+   +   +   +
|           |               |                           |   |   |
+   +   +---+---+---+---+   +   +---+---+---+---+---+   +   +   +
|   |   |                   |                       |   |   |   |
+   +   +   +---+---+---+---+---+---+---+---+---+   +   +   +   +
|   |   |                                           |       |   |
+   +   +---+---+---+---+---+---+---+---+---+---+---+---+---+   +
|   |                                                           |
+---+---+---+---+---+---+---+---+---+---+---+---+---+---+---+---+
