+---+---+---+---+---+---+---+---+---+---+---+---+---+---+---+---+
|       |                       |                               |
+   +---+   +---+   +   +---+   +   +---+---+---+---+---+---+   +
|   |       |       |                                       |   |
+   +   +---+   +   +   +---+---+---+---+---+---+---+---+   +   +
|       |       |   |                                   |       |
+   +---+   +---+   +---+   +---+---+---+---+---+---+   +   +   +
|           |       |                               |       |   |
+   +   +---+   +   +   +---+---+---+---+---+---+   +   +---+   +
|   |   |       |       |                       |       |   |   |
+   +   +   +---+   +---+   +---+---+---+---+   +   +   +   +   +
|   |   |   |       |       |               |       |   |   |   |
+   +   +   +   +   +   +---+   +---+---+   +   +   +   +   +   +
|   |   |   |   |                       |       |   |   |   |   |
+   +   +   +   +   +---+   +---+---+   +   +   +   +   +   +   +
|       |   |   |   |       |       |   |   |   |   |   |       |
+---+   +   +   +   +   +---+   +   +   +   +   +   +   +   +---+
|       |   |   |   |   |           |       |   |   |   |       |
+   +   +   +   +   +   +   +---+---+   +---+   +   +   +   +   +
|   |   |   |   |   |   |               |       |   |   |   |   |
+   +   +   +   +   +   +---+---+   +---+   +---+   +   +   +   +
|   |   |   |   |   |               |                   |   |   |
+   +   +   +   +   +---+   +---+---+   +---+   +---+---+   +   +
|   |   |   |   |                       |       |           |   |
+   +   +   +   +---+   +---+---+---+---+   +---+   +---+   +   +
|   |   |   |                               |       |       |   |
+   +   +   +---+---+---+---+---+---+   +---+   +---+   +---+   +
|   |                                           |       |       |
+   +   +---+---+---+---+---+---+---+---+---+---+   +---+---+   +
|   |                                               |           |
+   +---+---+---+---+---+---+   +   +---+---+---+---+   +   +---+
|   |                           |                       |       |
+---+---+---+---+---+---+---+---+---+---+---+---+---+---+---+---+
