+---+---+---+---+---+---+---+---+---+---+---+---+---+---+---+---+
|                                                           |   |
+   +---+---+   +---+   +   +---+   +---+---+   +---+---+   +---+
|   |   |       |       |   |           |                       |
+   +---+   +---+   +---+   +---+   +---+   +---+   +---+---+   +
|   |       |       |                   |                       |
+   +   +---+   +---+---+---+---+   +---+---+   +---+   +---+   +
|       |       |           |           |                   |   |
+   +---+   +---+   +---+   +---+   +---+   +---+---+---+   +   +
|   |       |       |       |           |                       |
+   +   +---+   +---+   +   +---+   +---+   +---+   +---+---+   +
|       |       |   |   |   |               |   |   |           |
+   +---+   +---+---+   +   +---+   +---+   +   +   +   +---+   +
|   |       |           |       |               |   |       |   |
+   +   +---+   +---+---+   +---+---+   +   +---+   +---+   +   +
|       |   |   |       |   |       |   |   |           |   |   |
+   +---+---+   +   +   +   +   +   +   +---+   +   +   +   +   +
|               |   |   |           |   |       |   |   |   |   |
+---+---+---+---+   +   +---+---+---+---+   +---+   +   +   +   +
|                                   |       |   |   |   |   |   |
+---+---+---+   +---+---+---+   +---+   +---+---+   +   +   +   +
|                               |       |           |   |   |   |
+---+---+   +---+---+---+   +---+   +---+   +---+---+   +   +   +
|                           |       |   |   |           |   |   |
+   +---+---+---+   +---+---+   +---+---+   +   +---+   +   +   +
|   |           |                           |   |   |   |   |   |
+   +   +---+   +   +---+   +   +---+---+---+   +---+   +   +   +
|   |               |   |   |                           |   |   |
+   +   +---+---+   +---+   +---+---+---+---+---+---+---+   +   +
|       |                                                   |   |
+   +   +---+---+---+---+---+---+---+---+---+---+---+---+---+   +
|   |                                                           |
+---+---+---+---+---+---+---+---+---+---+---+---+---+---+---+---+
