+---+---+---+---+---+---+---+---+---+---+---+---+---+---+---+---+
|       |                       |                               |
+   +---+   +---+   +   +---+   +   +---+---+---+---+---+---+   +
|   |       |       |                           |           |   |
+   +   +---+   +   +   +---+---+---+---+---+   +   +---+   +   +
|       |       |   |                           |       |       |
+   +---+   +---+   +---+   +---+---+---+---+---+---+   +   +   +
|           |       |       |                       |       |   |
+   +   +---+   +   +   +---+---+---+---+---+---+   +   +---+   +
|   |   |       |       |                       |       |   |   |
+   +---+   +---+   +---+   +---+---+---+---+   +   +   +   +   +
|   |   |   |       |       |               |       |   |   |   |
+   +   +   +   +   +---+---+   +---+---+   +   +   +   +   +   +
|   |   |   |   |           |           |       |   |   |   |   |
+   +   +   +   +   +---+   +---+---+   +   +---+   +   +   +   +
|       |   |   |   |       |       |   |   |   |   |   |       |
+---+   +   +   +   +   +---+   +   +   +   +   +   +   +   +---+
|       |   |   |   |   |           |       |   |   |   |       |
+   +   +   +   +   +   +   +---+---+   +---+   +   +   +   +   +
|   |   |   |   |   |   |               |       |   |   |   |   |
+   +   +   +   +   +   +---+---+---+---+   +---+   +   +   +   +
|   |   |   |   |   |               |           |       |   |   |
+   +   +   +   +   +---+   +---+---+   +---+   +---+---+   +   +
|   |   |   |   |                       |       |           |   |
+   +   +   +   +---+   +---+---+---+---+   +---+   +---+   +   +
|   |   |   |                               |       |       |   |
+   +   +   +---+---+---+---+---+---+   +---+   +---+   +---+   +
|   |                                           |       |       |
+   +   +---+---+---+---+---+---+---+---+---+---+   +---+---+   +
|   |                                               |           |
+   +---+---+---+---+---+---+   +   +---+---+---+---+   +   +---+
|   |                           |                       |       |
+---+---+---+---+---+---+---+---+---+---+---+---+---+---+---+---+
