+---+---+---+---+---+---+---+---+---+---+---+---+---+---+---+---+
|               |   |                                           |
+   +---+---+---+   +---+---+---+---+---+---+   +---+   +---+   +
|   |                                       |   |   |   |   |   |
+   +---+---+---+   +   +   +---+---+---+   +   +   +   +   +   +
|                   |   |                   |   |   |   |   |   |
+   +---+---+   +---+   +   +---+---+---+   +   +   +   +   +   +
|   |               |   |   |               |   |   |   |   |   |
+   +   +---+---+---+   +   +   +   +---+   +---+   +   +   +   +
|   |   |               |   |   |   |           |   |   |   |   |
+   +   +   +---+---+---+---+---+   +---+   +   +   +   +   +   +
|   |   |   |       |                   |   |   |   |   |   |   |
+   +   +   +   +   +   +---+---+---+---+   +   +   +   +   +---+
|   |   |   |   |   |   |               |   |   |               |
+   +   +   +   +   +   +   +---+---+   +   +   +---+   +---+---+
|   |   |       |   |   |   |           |   |       |           |
+   +   +---+   +   +   +   +   +   +   +   +---+   +   +---+---+
|   |           |   |   |   |       |   |   |   |   |   |       |
+   +---+---+---+   +---+---+---+---+   +   +   +   +   +   +   +
|   |           |       |               |   |   |   |       |   |
+   +---+---+   +   +   +   +---+---+   +---+   +   +   +---+   +
|               |   |   |   |       |       |   |   |   |       |
+   +---+---+   +   +   +   +   +   +---+   +   +   +   +---+---+
|   |               |   |   |   |           |               |   |
+   +---+   +   +   +   +   +   +---+---+---+---+   +   +   +   +
|   |       |   |   |   |                       |   |   |       |
+   +   +---+   +---+   +   +---+---+---+   +---+   +   +   +   +
|   |   |       |       |   |                       |   |   |   |
+   +   +   +---+   +   +---+   +---+---+   +---+---+   +   +   +
|       |   |       |                                   |   |   |
+   +---+   +   +   +   +---+   +---+---+---+---+---+---+   +---+
|   |           |   |       |                                   |
+---+---+---+---+---+---+---+---+---+---+---+---+---+---+---+---+
