+---+---+---+---+---+---+---+---+---+---+---+---+---+---+---+---+
|                                                               |
+   +---+---+---+---+---+---+---+---+---+---+---+---+---+---+   +
|   |                                                       |   |
+   +   +---+---+---+---+---+---+---+---+---+---+---+---+   +   +
|   |   |                                               |   |   |
+   +   +   +---+---+---+---+   +---+   +---+---+---+   +   +   +
|   |   |   |   |           |       |       |       |   |   |   |
+   +   +   +   +   +---+   +   +---+   +---+   +   +   +   +   +
|   |   |       |   |       |   |       |       |   |   |   |   |
+   +   +---+   +   +   +---+   +   +---+   +---+   +   +   +   +
|   |   |   |   |   |           |   |       |       |   |   |   |
+   +   +   +   +   +---+---+   +   +   +---+   +---+   +   +   +
|   |   |       |   |       |   |       |       |   |   |   |   |
+   +   +   +---+   +   +   +---+---+---+   +---+   +   +   +   +
|   |   |   |   |   |   |   |       |       |       |   |   |   |
+   +   +   +   +   +   +   +   +   +   +---+   +   +   +   +   +
|   |   |       |   |   |   |       |           |   |   |   |   |
+   +   +   +---+   +   +   +---+   +   +---+   +   +   +   +   +
|                   |   |           |   |           |   |   |   |
+   +---+   +---+   +   +---+---+   +---+   +---+---+   +   +   +
|   |               |           |   |       |       |   |   |   |
+   +   +---+   +---+---+---+   +   +   +---+   +   +   +   +   +
|                           |   |   |           |   |   |   |   |
+   +---+   +---+   +---+   +   +   +---+---+---+   +   +   +   +
|                           |   |                   |   |   |   |
+   +---+   +---+   +---+   +   +---+---+---+---+---+   +   +   +
|                           |   |                       |   |   |
+   +   +---+   +---+   +   +   +---+---+---+---+---+---+   +   +
|   |                   |   |                               |   |
+   +---+   +---+   +---+   +---+---+---+---+---+---+---+---+   +
|   |                                                           |
+---+---+---+---+---+---+---+---+---+---+---+---+---+---+---+---+
