+---+---+---+---+---+---+---+---+---+---+---+---+---+---+---+---+
|               |                                               |
+   +   +   +   +   +---+---+---+---+---+---+---+---+---+   +   +
|   |   |   |   |   |               |                       |   |
+   +   +   +   +   +   +---+---+   +---+   +---+---+---+---+---+
|   |   |   |   |   |       |       |                           |
+   +   +   +   +   +---+   +   +---+   +---+   +---+   +---+   +
|   |       |   |       |   |   |                           |   |
+   +   +   +   +   +---+   +   +---+   +---+---+---+---+   +   +
|   |   |       |   |       |       |               |           |
+   +   +   +   +   +   +   +---+   +---+---+---+   +---+---+   +
|   |   |   |   |   |   |   |       |       |   |   |           |
+   +   +   +   +   +   +---+   +---+   +   +---+   +   +---+---+
|   |   |   |   |   |       |           |           |   |       |
+   +   +   +   +   +   +   +---+---+---+---+---+---+   +   +   +
|   |           |   |   |   |                               |   |
+   +   +   +   +   +---+   +   +   +---+---+---+---+---+---+   +
|   |   |   |   |   |       |       |                       |   |
+   +   +   +   +   +   +---+---+---+   +---+   +---+---+   +   +
|   |       |   |   |               |       |       |       |   |
+   +   +   +   +   +   +   +---+   +---+   +---+   +   +   +   +
|   |   |       |   |   |   |           |       |       |   |   |
+   +   +   +   +   +   +---+   +---+   +---+   +---+   +   +   +
|   |   |   |   |   |   |       |   |       |       |       |   |
+   +   +---+   +   +   +   +---+   +---+   +---+   +---+   +   +
|   |               |       |           |       |       |       |
+   +---+   +---+---+   +---+---+   +---+---+   +---+   +---+   +
|   |       |           |                   |       |       |   |
+   +---+---+---+   +   +---+   +---+   +---+---+   +---+   +---+
|       |           |                           |       |       |
+   +   +---+   +---+   +---+---+---+---+   +---+---+   +---+   +
|   |                                               |           |
+---+---+---+---+---+---+---+---+---+---+---+---+---+---+---+---+
