+---+---+---+---+---+---+---+---+---+---+---+---+---+---+---+---+
|                                                       |       |
+   +   +---+---+---+---+   +   +---+---+   +---+---+   +   +   +
|   |   |               |   |   |                   |   |   |   |
+   +   +   +---+---+---+   +   +---+   +---+---+   +   +   +   +
|   |   |   |               |                               |   |
+   +---+   +---+---+---+   +---+---+---+---+---+---+   +---+   +
|       |                                                   |   |
+---+   +   +---+   +---+   +   +---+---+   +---+---+   +   +   +
|       |       |   |       |           |   |   |   |   |   |   |
+   +---+   +   +   +---+---+---+---+   +   +   +   +---+   +   +
|   |   |   |                       |       |               |   |
+   +   +---+   +---+   +---+---+   +---+   +   +   +---+---+   +
|   |           |       |       |       |   |   |               |
+   +---+---+   +   +---+   +   +---+   +   +   +   +---+   +---+
|       |       |   |       |       |   |   |       |           |
+   +   +   +---+---+   +---+   +   +   +   +   +   +   +---+   +
|   |   |   |       |       |       |   |   |   |           |   |
+   +   +   +   +---+---+   +---+---+   +   +   +   +   +   +   +
|   |   |   |           |               |   |       |   |   |   |
+   +   +   +---+---+   +---+   +---+---+   +---+---+   +   +   +
|   |   |       |               |                   |   |   |   |
+   +   +   +   +---+   +---+---+   +---+---+---+---+   +   +   +
|       |   |       |   |           |       |                   |
+   +   +   +---+   +   +---+---+---+   +   +   +---+   +   +---+
|   |   |                   |           |   |           |       |
+   +   +---+---+---+---+---+   +---+---+   +   +---+---+   +   +
|   |                       |   |                       |   |   |
+   +   +---+---+---+---+   +   +   +---+---+   +---+---+   +   +
|   |                           |   |       |               |   |
+   +---+---+   +   +---+---+---+   +---+   +---+---+   +   +   +
|   |           |                                       |   |   |
+---+---+---+---+---+---+---+---+---+---+---+---+---+---+---+---+
