+---+---+---+---+---+---+---+---+---+---+---+---+---+---+---+---+
|                                                   |           |
+---+---+---+   +---+---+   +---+   +---+---+   +---+---+   +   +
|           |   |   |               |       |               |   |
+   +   +   +   +   +   +---+---+---+   +---+---+---+---+   +   +
|   |   |   |   |   |       |   |                       |       |
+   +   +   +   +   +---+   +   +   +---+---+---+---+   +---+   +
|           |   |   |       |       |               |           |
+   +---+   +   +   +   +---+   +---+---+   +---+   +---+---+   +
|       |   |   |   |       |   |               |               |
+---+   +   +   +   +---+   +   +   +---+---+---+---+---+---+---+
|           |   |   |       |   |                   |       |   |
+   +---+   +   +   +   +---+   +---+---+   +---+   +   +   +   +
|       |   |   |   |       |           |               |       |
+---+   +   +   +   +---+   +---+---+   +   +   +---+   +   +   +
|       |   |   |   |       |       |   |   |               |   |
+   +---+   +   +   +   +---+   +   +   +   +   +   +---+   +   +
|       |   |   |       |   |       |   |       |               |
+---+   +   +   +   +---+   +---+   +   +---+   +   +   +---+   +
|       |   |       |       |       |       |       |           |
+   +---+   +   +---+   +   +---+   +---+   +---+   +   +   +---+
|       |       |       |       |       |       |       |       |
+---+   +---+---+   +---+---+   +---+   +---+   +---+   +   +   +
|           |       |       |       |       |       |       |   |
+   +---+---+   +   +   +   +---+   +---+   +---+   +---+   +   +
|       |       |   |   |       |       |       |       |   |   |
+---+   +   +---+---+   +---+   +---+   +---+   +---+   +---+   +
|               |                   |       |       |       |   |
+   +---+---+   +   +---+   +---+   +---+   +---+   +---+   +   +
|   |           |                           |               |   |
+   +   +---+---+---+---+---+---+---+---+---+---+---+---+---+   +
|   |                                                           |
+---+---+---+---+---+---+---+---+---+---+---+---+---+---+---+---+
