+---+---+---+---+---+---+---+---+---+---+---+---+---+---+---+---+
|               |                                       |       |
+   +---+   +---+   +---+   +---+---+---+---+---+---+   +   +   +
|   |               |       |                           |   |   |
+   +   +---+   +---+   +---+   +---+---+---+---+---+---+   +   +
|       |       |       |                           |       |   |
+   +   +   +---+   +---+---+---+---+---+---+---+   +   +   +   +
|   |       |       |                               |   |   |   |
+   +   +---+   +---+   +---+---+---+---+---+---+---+   +   +   +
|       |       |                                   |   |   |   |
+   +---+   +---+---+---+---+---+---+---+---+   +---+   +   +   +
|   |       |   |   |   |   |                   |       |   |   |
+   +   +---+   +   +   +   +   +---+---+---+---+   +---+   +   +
|       |   |                       |           |   |       |   |
+   +---+   +   +   +   +   +---+---+   +---+   +   +   +---+   +
|           |   |   |   |   |       |       |   |   |       |   |
+   +   +   +   +   +---+---+   +   +---+   +   +   +---+   +   +
|   |   |   |                       |       |   |   |       |   |
+   +   +   +   +---+---+---+---+---+   +---+   +   +   +---+   +
|           |                               |   |   |       |   |
+---+   +   +   +   +---+---+---+---+---+---+   +   +---+   +   +
|   |   |   |   |   |       |       |       |       |       |   |
+   +   +   +---+---+   +   +   +   +   +   +---+---+   +---+   +
|       |               |       |       |   |                   |
+   +   +---+   +---+   +---+---+---+   +   +   +---+   +---+   +
|   |                   |               |                   |   |
+   +---+   +   +---+---+   +---+---+   +---+---+   +---+   +   +
|           |       |           |           |               |   |
+   +---+   +---+   +   +---+---+---+---+   +   +---+---+---+   +
|   |   |       |       |               |       |               |
+   +   +---+   +---+---+   +---+---+   +---+---+   +---+---+   +
|   |                           |                       |       |
+---+---+---+---+---+---+---+---+---+---+---+---+---+---+---+---+
