+---+---+---+---+---+---+---+---+---+---+---+---+---+---+---+---+
|       |   |   |       |       |       |               |       |
+   +---+   +   +   +   +   +   +   +   +---+---+---+   +---+   +
|           |       |       |       |           |       |   |   |
+   +---+   +   +---+---+---+---+---+---+   +   +   +   +   +   +
|       |       |           |       |       |   |   |           |
+   +---+---+   +---+   +---+   +   +   +---+   +   +   +   +---+
|       |                   |   |           |       |   |       |
+   +---+---+---+   +---+   +   +   +---+---+   +---+   +   +---+
|                       |       |       |       |       |       |
+---+   +---+   +---+   +---+---+   +---+   +---+---+   +   +   +
|       |       |       |           |   |       |       |   |   |
+---+   +---+---+---+---+   +---+---+   +---+   +   +---+   +   +
|   |       |               |       |                           |
+   +   +---+   +---+---+---+---+---+   +---+---+   +   +---+---+
|       |   |       |   |   |                   |   |           |
+   +   +   +   +   +---+   +   +   +   +---+---+   +   +---+   +
|   |   |       |   |   |   |       |   |       |   |   |       |
+   +---+---+   +   +   +   +---+---+   +   +   +   +---+---+   +
|                   |   |       |       |   |               |   |
+   +---+   +   +---+   +   +   +---+---+---+   +---+---+   +   +
|   |       |       |   |           |       |   |           |   |
+   +   +---+---+   +   +---+---+---+---+---+   +---+---+---+   +
|           |       |   |   |               |   |   |           |
+   +---+   +   +---+   +   +   +---+---+   +   +   +---+   +---+
|       |   |       |   |   |       |       |   |   |           |
+   +---+   +---+   +   +   +---+   +   +---+   +   +   +---+   +
|           |       |   |   |       |   |       |           |   |
+   +---+   +   +---+   +   +   +   +   +---+---+   +---+   +   +
|       |           |   |       |   |                   |       |
+   +   +---+---+---+---+   +---+   +   +---+   +---+---+   +---+
|   |                       |           |       |               |
+---+---+---+---+---+---+---+---+---+---+---+---+---+---+---+---+
