+---+---+---+---+---+---+---+---+---+---+---+---+---+---+---+---+
|                                   |                           |
+   +---+   +---+---+---+   +   +---+---+   +---+---+   +---+   +
|   |       |               |               |               |   |
+   +   +---+   +---+---+---+---+---+---+---+   +---+---+   +   +
|       |       |               |                       |       |
+   +---+   +---+   +---+---+   +---+---+   +---+---+   +   +   +
|   |       |   |   |   |           |               |       |   |
+   +   +---+---+   +---+   +---+---+   +---+---+   +   +   +   +
|   |   |           |       |                   |       |       |
+   +   +   +---+---+   +---+   +---+---+   +   +   +---+---+   +
|   |   |   |   |       |                   |       |   |       |
+   +   +   +---+   +---+   +---+---+---+   +   +---+   +   +---+
|           |       |   |               |           |       |   |
+   +---+---+   +---+   +   +---+---+   +   +   +---+   +---+   +
|   |           |       |   |       |       |   |       |   |   |
+   +   +---+---+   +   +   +   G   +   +   +   +   +---+   +   +
|   |   |   |   |   |   |   |       |   |       |   |           |
+---+   +   +   +   +   +   +   +---+   +   +---+   +   +   +   +
|   |   |       |   |   |                   |       |   |   |   |
+   +   +   +   +   +   +---+---+---+---+---+   +---+   +   +   +
|       |   |   |   |                   |       |   |   |   |   |
+   +---+   +   +   +---+---+---+   +---+   +---+---+   +   +   +
|   |       |   |           |       |       |           |   |   |
+   +   +   +   +---+---+   +   +---+   +---+   +---+---+   +   +
|   |   |   |               |           |   |   |   |       |   |
+   +   +   +---+---+---+---+---+   +---+---+   +---+   +---+   +
|   |   |                       |               |       |       |
+   +---+---+---+   +---+---+---+---+---+---+---+   +---+   +   +
|                   |                               |       |   |
+   +---+   +---+---+   +---+---+---+   +---+   +---+   +---+   +
|SSS|                                                           |
+---+---+---+---+---+---+---+---+---+---+---+---+---+---+---+---+
