+---+---+---+---+---+---+---+---+---+---+---+---+---+---+---+---+
|                           |       |           |       |       |
+   +---+---+---+   +---+---+---+   +---+   +   +   +   +   +   +
|   |               |               |       |       |   |   |   |
+   +---+   +---+---+   +   +   +---+   +---+---+   +   +   +   +
|   |       |           |   |   |   |       |   |   |   |   |   |
+   +   +   +   +---+---+   +   +---+   +---+   +   +   +   +   +
|   |   |   |       |   |   |           |       |   |   |   |   |
+   +---+   +   +---+   +   +---+---+---+   +   +   +   +   +   +
|       |   |       |   |           |       |       |   |   |   |
+---+   +   +---+   +   +---+   +---+   +---+   +   +   +   +   +
|   |   |       |   |           |           |   |   |       |   |
+---+   +---+   +   +---+---+   +   +---+   +   +   +---+   +   +
|           |   |       |           |           |   |       |   |
+   +---+   +   +---+   +   +   +---+   +---+   +---+   +---+   +
|   |   |   |           |   |       |       |   |       |       |
+---+   +   +---+---+---+   +   +   +---+   +---+   +---+   +   +
|   |   |           |       |       |   |       |   |       |   |
+   +   +---+---+   +---+   +---+---+   +---+   +   +   +---+---+
|   |   |       |   |   |                       |   |   |       |
+   +   +---+   +   +   +---+   +---+---+---+   +   +   +   +   +
|   |               |   |   |                   |   |   |   |   |
+   +   +---+---+---+   +   +---+   +---+---+   +   +   +   +   +
|                   |       |   |               |   |   |   |   |
+---+---+---+   +   +   +   +   +---+   +---+   +   +   +   +   +
|               |       |   |       |           |   |   |   |   |
+   +---+---+---+---+---+   +   +   +---+   +---+   +   +   +   +
|                       |       |       |           |       |   |
+---+---+---+---+---+   +---+---+   +---+---+---+---+   +---+   +
|                               |               |   |   |       |
+   +   +---+---+---+---+---+   +   +   +---+---+   +---+   +   +
|   |                               |                       |   |
+---+---+---+---+---+---+---+---+---+---+---+---+---+---+---+---+
