+---+---+---+---+---+---+---+---+---+---+---+---+---+---+---+---+
|           |                                                   |
+   +---+   +   +---+---+---+---+---+---+---+---+---+---+---+   +
|   |   |   |               |                               |   |
+   +   +   +---+   +   +---+   +   +---+---+---+---+---+   +   +
|   |       |   |   |   |       |       |               |   |   |
+   +   +---+   +---+   +   +   +   +---+   +---+   +---+   +   +
|   |   |       |       |   |           |       |       |   |   |
+   +   +   +---+   +---+   +   +   +   +---+   +---+   +   +   +
|   |   |   |       |       |   |   |       |       |   |       |
+   +   +   +   +---+   +---+   +   +---+   +---+   +   +---+---+
|   |   |       |       |       |       |           |   |       |
+   +   +   +   +   +   +---+   +   +---+   +   +   +   +   +   +
|   |   |   |   |   |   |               |   |   |   |   |   |   |
+   +   +   +---+   +   +   +---+---+   +   +---+---+   +   +   +
|   |   |   |   |   |   |               |   |       |   |   |   |
+   +   +   +   +   +   +---+   +   +---+   +   +   +   +   +   +
|   |   |   |   |   |       |       |       |   |   |   |   |   |
+   +   +   +   +   +---+   +---+---+   +---+   +   +   +   +   +
|   |       |   |       |       |       |       |   |   |   |   |
+   +---+---+   +---+   +---+   +   +---+   +---+   +   +   +   +
|   |               |       |       |       |       |       |   |
+   +   +   +---+   +---+   +---+---+   +---+   +---+---+---+   +
|   |   |   |   |       |       |       |       |               |
+   +   +---+   +---+   +---+   +   +---+   +---+   +---+---+---+
|   |   |   |       |       |       |       |                   |
+   +   +   +---+   +---+   +---+---+   +---+---+---+---+---+   +
|   |       |           |               |                       |
+   +---+   +---+---+   +---+---+---+---+---+---+   +---+---+---+
|       |                                   |                   |
+   +   +---+---+---+---+---+---+   +---+---+---+---+---+---+   +
|   |                                                           |
+---+---+---+---+---+---+---+---+---+---+---+---+---+---+---+---+
