+---+---+---+---+---+---+---+---+---+---+---+---+---+---+---+---+
|       |       |           |       |               |           |
+   +   +   +   +   +---+   +   +   +   +   +---+   +   +   +   +
|   |   |   |   |       |       |   |   |   |       |   |   |   |
+   +   +   +   +---+   +---+---+   +   +   +   +---+   +---+   +
|   |   |   |       |           |       |   |   |   |   |       |
+   +   +   +---+   +---+---+   +---+---+   +   +---+   +   +---+
|   |   |   |   |           |           |   |   |   |   |       |
+   +   +   +---+---+---+   +---+---+   +   +   +---+   +---+   +
|   |       |       |   |               |   |           |       |
+   +---+   +---+   +---+---+---+---+---+   +---+---+---+---+   +
|   |   |       |                           |           |       |
+   +   +   +---+   +---+---+---+---+   +   +   +---+   +   +---+
|       |   |                       |   |   |   |       |       |
+   +   +---+---+---+---+   +---+---+   +   +   +   +---+---+   +
|   |   |       |           |           |       |       |       |
+   +   +   +   +   +   +---+   +   +---+   +---+---+   +   +---+
|   |   |   |   |   |       |       |   |   |   |       |       |
+---+   +   +   +---+---+   +---+---+---+---+   +   +---+---+   +
|   |   |   |   |       |   |       |           |       |       |
+---+   +   +   +   +   +   +   +   +   +---+   +---+   +   +---+
|       |   |   |   |   |   |   |   |   |   |           |       |
+   +   +   +   +   +   +   +   +   +   +   +---+   +---+   +   +
|   |   |   |   |   |   |       |           |       |       |   |
+   +   +   +   +   +   +---+---+---+   +---+   +---+   +---+   +
|   |   |   |   |   |                   |       |       |       |
+   +   +   +   +   +---+---+---+---+---+   +---+   +---+   +   +
|   |   |   |                               |       |       |   |
+   +   +   +---+---+---+---+---+---+   +---+   +---+   +   +   +
|   |   |                           |           |       |   |   |
+   +   +---+---+---+---+   +---+---+---+---+---+   +---+   +   +
|   |                                                           |
+---+---+---+---+---+---+---+---+---+---+---+---+---+---+---+---+
