+---+---+---+---+---+---+---+---+---+---+---+---+---+---+---+---+
|                                                               |
+   +   +   +   +   +   +   +   +   +   +   +   +   +   +   +   +
|                                                               |
+   +   +   +   +   +   +   +   +   +   +   +   +   +   +   +   +
|                                                               |
+   +   +   +   +   +   +   +   +   +   +   +   +   +   +   +   +
|                                                               |
+   +   +   +   +   +   +   +   +   +   +   +   +   +   +   +   +
|                                                               |
+   +   +   +   +   +   +   +   +   +   +   +   +   +   +   +   +
|                                                               |
+   +   +   +   +   +   +   +   +   +   +   +   +   +   +   +   +
|                                                               |
+   +   +   +   +   +   +   +---+---+   +   +   +   +   +   +   +
|                           |       |                           |
+   +   +   +   +   +   +   +   +   +   +   +   +   +   +   +   +
|                           |       |                           |
+   +   +   +   +   +   +   +---+---+   +   +   +   +   +   +   +
|                                                               |
+   +   +   +   +   +   +   +   +   +   +   +   +   +   +   +   +
|                                                               |
+   +   +   +   +   +   +   +   +   +   +   +   +   +   +   +   +
|                                                               |
+   +   +   +   +   +   +   +   +   +   +   +   +   +   +   +   +
|                                                               |
+   +   +   +   +   +   +   +   +   +   +   +   +   +   +   +   +
|                                                               |
+   +   +   +   +   +   +   +   +   +   +   +   +   +   +   +   +
|   |                                                           |
+   +   +   +   +   +   +   +   +   +   +   +   +   +   +   +   +
|   |                                                           |
+---+---+---+---+---+---+---+---+---+---+---+---+---+---+---+---+

