+---+---+---+---+---+---+---+---+---+---+---+---+---+---+---+---+
|   |                       |               |           |       |
+   +---+---+---+---+---+   +   +   +---+   +---+   +   +   +---+
|       |               |       |       |           |           |
+   +   +   +   +---+---+   +---+   +   +---+   +---+   +---+   +
|   |   |   |               |       |   |   |   |           |   |
+   +   +   +   +---+   +---+   +---+   +   +   +   +---+   +   +
|   |       |   |       |       |       |   |   |               |
+   +---+---+---+   +---+   +---+   +---+   +   +---+   +   +   +
|                   |       |       |       |   |       |   |   |
+   +---+---+---+---+   +---+   +---+   +   +   +   +---+   +---+
|               |       |       |       |   |   |               |
+   +---+---+---+   +---+   +---+   +   +   +   +---+   +---+   +
|           |       |       |       |   |   |   |           |   |
+   +---+---+   +---+   +---+---+---+   +   +   +   +---+   +   +
|       |       |       |   |       |   |   |   |       |       |
+   +---+   +---+   +---+   +   +   +   +   +   +---+   +   +   +
|   |       |       |       |       |       |   |           |   |
+   +   +---+   +---+   +   +---+   +   +   +   +   +---+   +---+
|       |       |       |           |   |   |   |               |
+   +---+   +---+   +---+   +   +   +   +   +   +---+   +---+   +
|   |       |           |   |   |   |   |   |   |           |   |
+   +   +---+   +---+---+---+---+   +   +   +   +   +---+   +   +
|   |   |                   |   |   |   |   |   |               |
+   +   +---+---+---+---+   +   +   +   +   +   +---+   +   +   +
|   |                   |       |   |   |   |   |       |   |   |
+   +   +---+   +---+   +---+   +   +   +   +   +   +---+   +   +
|   |   |       |   |       |   |   |   |       |           |   |
+   +   +   +   +   +---+   +---+   +---+---+---+---+   +   +---+
|   |   |   |   |       |               |       |       |       |
+   +   +   +   +   +   +---+   +   +   +   +   +   +   +   +   +
|   |       |       |           |   |       |       |       |   |
+---+---+---+---+---+---+---+---+---+---+---+---+---+---+---+---+

