+---+---+---+---+---+---+---+---+---+---+---+---+---+---+---+---+
|       |                   |                                   |
+   +---+---+---+---+---+   +   +---+---+---+---+---+---+---+   +
|                       |   |   |                           |   |
+   +   +---+---+---+   +   +   +   +---+---+---+---+---+   +   +
|   |   |           |   |   |   |   |       |           |   |   |
+   +   +   +---+   +   +   +   +   +   +   +   +---+   +   +   +
|   |   |   |   |   |   |   |   |   |   |   |       |   |   |   |
+   +   +   +---+   +   +   +   +   +   +   +---+   +   +   +   +
|   |   |               |   |   |   |   |   |       |   |   |   |
+   +   +---+   +---+---+   +   +   +   +   +   +   +   +   +   +
|   |   |                       |       |       |   |   |   |   |
+   +---+---+---+---+---+---+   +   +---+---+---+---+   +   +   +
|                           |   |   |                   |   |   |
+   +---+---+---+---+---+---+---+---+   +---+---+---+---+   +   +
|                           |       |   |                   |   |
+---+---+---+---+---+---+   +   +   +   +   +---+---+---+---+   +
|   |                       |       |   |                       |
+   +   +---+   +---+---+---+---+   +   +---+---+---+---+---+---+
|   |   |   |   |           |   |   |   |       |       |       |
+   +   +   +   +   +---+   +   +   +   +   +   +   +   +   +   +
|   |   |   |           |       |   |   |   |       |       |   |
+   +   +   +   +---+   +   +   +   +   +   +---+---+---+---+   +
|   |   |   |   |   |   |   |   |   |   |       |       |   |   |
+   +   +   +   +---+   +   +   +   +   +---+   +   +   +   +   +
|   |   |   |           |   |   |   |   |   |   |   |   |   |   |
+   +   +   +---+---+---+   +   +   +   +   +   +   +   +   +   +
|   |   |                   |   |   |   |   |       |       |   |
+   +---+---+---+---+---+---+   +   +   +   +---+---+---+   +   +
|                           |   |   |                       |   |
+   +---+---+---+---+---+   +   +   +---+---+---+---+---+---+   +
|   |                           |                               |
+---+---+---+---+---+---+---+---+---+---+---+---+---+---+---+---+

