+---+---+---+---+---+---+---+---+---+---+---+---+---+---+---+---+
|       |       |                                               |
+---+   +   +   +   +---+---+---+---+---+---+---+   +---+   +---+
|   |       |   |   |                               |   |   |   |
+   +   +---+   +   +   +---+---+---+---+---+---+   +---+   +---+
|           |       |                                           |
+   +---+   +---+---+---+---+   +---+---+---+---+---+---+   +---+
|       |   |                                       |   |   |   |
+   +---+   +   +---+---+---+---+---+---+---+   +---+---+   +---+
|   |       |       |       |       |       |       |           |
+---+   +   +---+   +   +   +   +   +   +   +---+   +   +---+   +
|       |   |       |           |       |   |       |   |   |   |
+   +---+   +   +---+   +   +---+---+---+   +   +---+   +---+   +
|   |       |       |   |               |   |       |           |
+   +---+   +---+   +   +   +---+---+   +   +---+   +   +---+   +
|       |   |       |   |   |           |           |           |
+   +   +---+   +---+   +   +   +   +   +   +   +---+---+   +---+
|   |       |           |   |       |   |   |       |           |
+   +---+   +---+   +   +   +---+---+   +   +---+   +   +---+   +
|       |   |       |   |               |   |       |           |
+   +---+   +   +---+   +---+---+---+   +   +   +---+   +---+   +
|   |       |       |   |       |       |   |       |   |   |   |
+---+   +---+---+   +   +   +   +   +   +   +---+   +   +---+   +
|       |   |       |       |       |       |       |           |
+   +---+   +   +---+---+---+---+---+---+---+   +---+---+   +---+
|   |       |                                       |   |   |   |
+   +---+   +---+---+---+---+---+   +---+---+---+---+---+   +---+
|       |                       |                               |
+   +   +---+   +---+   +---+   +   +---+---+---+   +---+   +---+
|   |       |   |   |       |   |                   |   |   |   |
+   +---+   +   +   +---+   +---+---+---+---+---+   +---+   +---+
|   |                   |                                       |
+---+---+---+---+---+---+---+---+---+---+---+---+---+---+---+---+

