+---+---+---+---+---+---+---+---+---+---+---+---+---+---+---+---+
|                                                               |
+---+   +---+---+---+---+---+---+---+---+---+---+---+---+   +---+
|                                   |   |   |   |   |   |   |   |
+---+---+---+---+---+---+   +   +   +---+   +---+   +---+   +---+
|                           |   |   |                           |
+---+---+---+---+---+---+   +   +   +   +---+   +---+   +---+   +
|                                   |   |   |   |   |   |   |   |
+   +   +---+---+---+---+---+---+---+   +---+   +---+   +---+   +
|   |                               |                           |
+   +   +---+---+---+---+---+---+---+---+   +---+   +---+   +---+
|                                   |   |   |   |   |   |   |   |
+---+---+---+---+---+---+   +   +   +---+   +---+   +---+   +---+
|                           |   |   |                           |
+---+---+---+---+---+---+   +---+---+   +---+   +---+   +---+   +
|                           |       |   |   |   |   |   |   |   |
+   +   +   +   +---+---+   +   +   +   +---+   +---+   +---+   +
|   |       |       |       |                                   |
+   +   +   +---+   +   +---+---+---+---+   +---+   +---+   +---+
|       |       |       |       |   |   |   |   |   |   |   |   |
+   +   +---+   +---+   +   +   +   +---+   +---+   +---+   +---+
|   |       |       |       |       |                           |
+   +   +   +---+   +   +---+   +   +   +---+   +---+   +---+   +
|       |               |       |   |   |   |   |   |   |   |   |
+   +   +   +   +   +---+   +   +   +   +---+   +---+   +---+   +
|   |   |   |   |           |   |   |                           |
+   +   +   +   +   +   +   +   +   +---+   +---+   +---+   +---+
|       |   |   |   |   |   |   |   |   |   |   |   |   |   |   |
+   +   +   +   +   +   +   +   +   +---+   +---+   +---+   +---+
|   |   |   |   |   |   |   |   |   |                           |
+   +   +   +   +   +   +   +   +   +---+---+---+---+   +---+   +
|   |               |   |                               |   |   |
+---+---+---+---+---+---+---+---+---+---+---+---+---+---+---+---+

