+---+---+---+---+---+---+---+---+---+---+---+---+---+---+---+---+
|                                                   |           |
+   +---+   +---+   +---+   +---+   +---+   +---+   +   +   +   +
|                                                       |   |   |
+   +---+   +---+   +---+   +---+   +---+   +---+   +   +   +   +
|                                                   |   |   |   |
+   +---+   +---+   +---+   +---+   +---+   +---+   +   +   +   +
|                                                       |   |   |
+   +---+   +---+   +---+   +---+   +---+   +---+   +   +   +   +
|                                                   |   |   |   |
+   +---+   +---+   +---+   +---+   +---+   +---+   +   +   +   +
|                                                       |   |   |
+   +---+   +---+   +---+   +---+---+---+---+---+---+---+   +   +
|                               |                           |   |
+   +---+   +---+   +---+   +---+   +---+---+---+---+---+---+   +
|                           |       |                           |
+   +---+   +---+   +---+   +   +   +   +---+   +---+   +---+   +
|                           |       |                           |
+   +---+   +---+   +---+   +---+---+---+   +---+   +---+   +   +
|                                                           |   |
+   +---+   +---+   +---+   +---+   +---+   +---+   +---+   +   +
|                                                               |
+   +---+   +---+   +---+   +---+   +---+   +---+   +---+   +   +
|                                                           |   |
+   +---+   +---+   +---+   +---+   +---+   +---+   +---+   +   +
|                                                               |
+   +---+   +---+   +---+   +---+   +---+   +---+   +---+   +   +
|                                                           |   |
+   +---+   +---+   +---+   +---+   +---+   +---+   +---+   +   +
|                                                               |
+   +   +---+   +---+   +---+   +---+   +---+   +---+   +---+   +
|   |                                                           |
+---+---+---+---+---+---+---+---+---+---+---+---+---+---+---+---+
