+---+---+---+---+---+---+---+---+---+---+---+---+---+---+---+---+
|       |                                                       |
+   +   +   +---+---+---+---+---+   +   +---+---+---+---+   +   +
|   |   |       |               |   |                   |   |   |
+   +   +---+   +   +---+---+---+   +   +---+---+---+   +   +   +
|   |           |                   |   |               |   |   |
+   +---+   +---+---+---+---+---+---+   +---+---+---+   +   +   +
|   |       |                                           |   |   |
+   +   +   +   +---+   +---+---+---+---+---+---+---+---+   +   +
|   |   |           |                               |       |   |
+   +   +---+   +   +   +---+---+---+---+---+   +   +   +   +   +
|   |       |   |   |                       |   |   |   |   |   |
+   +---+   +   +   +   +---+   +---+---+   +   +   +---+   +   +
|           |   |   |   |       |       |       |           |   |
+   +   +---+   +   +   +   +---+   +   +---+   +   +---+---+   +
|   |       |   |   |   |   |       |       |   |       |       |
+   +---+   +   +   +   +   +   A   +---+   +   +---+   +   +   +
|   |       |   |   |   |   |       |       |       |   |   |   |
+   +   +   +   +   +   +   +---+---+   +---+---+   +   +   +   +
|   |   |   |       |   |           |       |       |   |   |   |
+   +   +   +---+---+   +---+---+   +---+   +   +---+   +   +   +
|   |   |   |                   |       |       |       |   |   |
+   +   +   +---+---+---+---+   +---+   +   +---+   +   +   +   +
|   |   |           |       |       |       |       |   |   |   |
+   +   +   +---+   +   +   +---+   +---+   +   +---+   +   +   +
|       |       |   |   |       |                       |   |   |
+---+   +---+---+   +   +---+   +---+   +---+---+---+---+   +   +
|       |           |       |       |                       |   |
+   +   +---+---+   +---+   +---+   +---+---+---+---+---+   +   +
|   |               |   |       |                           |   |
+   +   +---+---+---+   +---+   +---+---+---+---+---+---+---+   +
|||||                                                           |
+---+---+---+---+---+---+---+---+---+---+---+---+---+---+---+---+
