+---+---+---+---+---+---+---+---+---+---+---+---+---+---+---+---+
|           |   |           |       |                           |
+   +---+   +   +   +---+   +   +   +   +   +   +   +   +   +   +
|   |   |   |   |       |       |   |   |   |   |   |   |   |   |
+   +   +   +   +   +---+   +---+---+   +   +   +   +   +   +   +
|   |   |   |       |               |   |   |   |   |   |   |   |
+   +   +   +   +---+---+   +---+   +   +   +   +   +   +   +   +
|   |   |   |   |       |   |       |   |   |   |   |   |   |   |
+   +   +   +   +   +   +   +   +---+   +   +   +   +   +   +   +
|   |   |   |   |   |   |   |       |   |   |   |   |   |   |   |
+   +   +   +   +   +   +   +   +   +   +   +   +   +   +   +   +
|   |   |       |   |   |   |   |   |   |   |   |   |   |   |   |
+   +   +   +---+---+   +   +   +   +   +   +   +   +   +   +   +
|   |   |           |       |   |   |   |   |   |   |   |   |   |
+   +   +   +---+   +---+   +---+---+   +   +   +   +   +   +   +
|   |           |       |   |       |   |   |   |   |   |   |   |
+   +   +   +---+---+   +   +   +   +   +   +   +   +   +   +   +
|   |   |   |       |   |   |       |                           |
+   +   +   +   +   +---+   +---+   +---+---+---+---+---+   +---+
|       |       |       |       |                           |   |
+---+   +   +   +   +   +   +   +   +   +---+---+---+---+---+   +
|   |   |   |   |   |   |   |       |                           |
+   +   +   +   +   +   +   +---+---+---+   +---+---+---+---+   +
|   |   |   |   |   |   |           |           |           |   |
+   +   +   +---+---+---+---+---+---+---+---+---+   +   +   +   +
|   |   |       |           |                       |   |       |
+   +   +---+   +   +---+   +---+   +---+   +---+   +---+---+   +
|                   |               |   |   |   |   |   |   |   |
+   +---+   +---+---+---+---+---+   +   +---+   +   +   +   +   +
|                           |       |       |   |       |   |   |
+   +---+---+---+---+   +   +   +   +   +   +   +   +   +   +   +
|   |                   |       |       |       |   |   |       |
+---+---+---+---+---+---+---+---+---+---+---+---+---+---+---+---+
