+---+---+---+---+---+---+---+---+---+---+---+---+---+---+---+---+
|           |       |       |       |       |       |       |   |
+---+   +   +   +   +   +   +   +   +   +   +   +   +   +   +   +
|       |       |       |       |       |       |       |       |
+   +---+---+---+---+---+---+---+---+---+---+---+---+---+---+   +
|       |           |       |       |       |       |   |       |
+---+   +---+   +   +   +   +   +   +   +   +   +   +   +   +---+
|       |       |       |       |       |       |       |       |
+   +---+   +---+---+---+---+---+---+---+---+---+---+   +---+   +
|       |       |           |       |       |   |       |       |
+---+   +---+   +---+   +   +   +   +   +   +   +   +---+   +---+
|       |       |       |       |       |       |       |       |
+   +---+   +---+   +---+---+---+---+---+---+   +---+   +---+   +
|       |       |       |               |       |       |       |
+---+   +---+   +---+   +   +---+---+   +   +---+   +---+   +---+
|       |       |       |   |       |   |       |       |       |
+   +---+   +---+   +---+   +   +   +   +---+   +---+   +---+   +
|       |       |       |   |       |   |       |       |       |
+---+   +---+   +---+   +   +   +---+   +   +---+   +---+   +---+
|       |       |           |           |       |       |       |
+   +---+   +---+---+---+---+---+---+---+---+   +---+   +---+   +
|       |       |       |       |       |       |       |       |
+---+   +   +   +   +   +   +   +   +   +   +---+   +---+   +---+
|       |   |       |       |       |           |       |       |
+   +---+---+---+---+---+---+---+---+---+---+---+---+   +---+   +
|       |       |       |       |       |       |       |       |
+---+   +   +   +   +   +   +   +   +   +   +   +   +---+   +---+
|   |       |       |       |       |       |           |       |
+   +---+---+---+---+---+---+---+---+---+---+---+---+---+---+   +
|       |       |       |       |       |       |       |       |
+   +   +   +   +   +   +   +   +   +   +   +   +   +   +   +---+
|   |       |       |       |       |       |       |           |
+---+---+---+---+---+---+---+---+---+---+---+---+---+---+---+---+
